Year,Team,LOC,Opp,Score_Team,Score_Opp,O_TotYd,O_PassY,O_RushY,D_TotYd,D_PassY,D_RushY,Tempurature ,Humidity,Wind,Percipitation,Average Temp (1st team),Difference,DOME,
2018,Arizona Cardinals,Home,Washington Redskins,6,24,213,145,68,429,247,182,68,70,0,0,75.05,7.05,0,
2018,Arizona Cardinals,Away,Los Angeles Rams,0,34,137,83,54,432,342,90,86,35,2,0,75.05,10.95,1,
2018,Arizona Cardinals,Home,Chicago Bears,14,16,221,168,53,316,194,122,68,70,0,0,75.05,7.05,0,
2018,Arizona Cardinals,Home,Seattle Seahawks,17,20,263,171,92,331,160,171,68,70,0,0,75.05,7.05,0,
2018,Arizona Cardinals,Away,San Francisco 49ers,28,18,220,164,56,447,300,147,79,19,15,0,75.05,3.95,1,
2018,Arizona Cardinals,Away,Minnesota Vikings,17,27,268,208,60,411,216,195,68,70,0,0,75.05,7.05,0,
2018,Arizona Cardinals,Home,Denver Broncos,10,45,223,154,69,309,178,131,82,27,6,0,75.05,6.95,1,
2018,Arizona Cardinals,Home,San Francisco 49ers,18,15,321,233,88,267,160,107,68,70,0,0,75.05,7.05,0,
2018,Arizona Cardinals,Away,Kansas City Chiefs,14,26,260,166,94,330,212,118,43,51,5,0,75.05,32.05,1,
2018,Arizona Cardinals,Home,Oakland Raiders,21,23,282,128,154,325,173,152,72,20,3,0,75.05,3.05,1,
2018,Arizona Cardinals,Away,Los Angeles Chargers,10,45,149,87,62,414,236,178,74,52,3,0,75.05,1.05,1,
2018,Arizona Cardinals,Away,Green Bay Packers,20,17,315,133,182,325,227,98,34,92,20,0,75.05,41.05,1,
2018,Arizona Cardinals,Home,Detroit Lions,3,17,279,218,61,218,96,122,70,41,2,0,75.05,5.05,1,
2018,Arizona Cardinals,Home,Los Angeles Rams,9,31,263,159,104,461,192,269,72,22,0,0,75.05,3.05,1,
2018,Arizona Cardinals,Away,Seattle Seahawks,24,27,198,113,85,291,109,182,45,76,5,0,75.05,30.05,1,
2017,Arizona Cardinals,Away,Detroit Lions,23,35,308,263,45,367,285,82,68,70,0,0,75.05,7.05,1,
2017,Arizona Cardinals,Away,Indianapolis Colts,16,13,389,306,83,266,190,76,78,66,6,0,75.05,2.95,1,
2017,Arizona Cardinals,Home,Dallas Cowboys,17,28,332,283,49,273,174,99,68,70,0,0,75.05,7.05,0,
2017,Arizona Cardinals,Home,San Francisco 49ers,18,15,368,317,51,305,210,95,68,70,0,0,75.05,7.05,0,
2017,Arizona Cardinals,Away,Philadelphia Eagles,7,34,307,276,31,419,297,122,77,91,10,1,75.05,1.95,1,
2017,Arizona Cardinals,Away,Los Angeles Rams,0,33,196,171,25,425,228,197,54,72,10,1,75.05,21.05,1,
2017,Arizona Cardinals,Away,San Francisco 49ers,20,10,368,201,167,329,266,63,61,48,8,0,75.05,14.05,1,
2017,Arizona Cardinals,Home,Seattle Seahawks,16,22,290,256,34,287,212,75,79,32,0,0,75.05,3.95,1,
2017,Arizona Cardinals,Away,Houston Texans,21,31,292,244,48,357,223,134,60,31,13,0,75.05,15.05,1,
2017,Arizona Cardinals,Home,Tennessee Titans,12,7,261,125,136,204,139,65,79,7,10,0,75.05,3.95,1,
2017,Arizona Cardinals,Away,Washington Redskins,15,20,286,145,141,218,187,31,50,47,1,0,75.05,25.05,1,
2017,Arizona Cardinals,Home,New York Giants,23,0,289,215,74,293,250,43,71,14,3,0,75.05,4.05,1,
2017,Arizona Cardinals,Away,Seattle Seahawks,26,24,259,143,116,296,195,101,40,78,7,0,75.05,35.05,1,
2016,Arizona Cardinals,Away,Los Angeles Rams,44,6,344,260,84,123,71,52,59,49,0,0,75.05,16.05,1,
2016,Arizona Cardinals,Away,Buffalo Bills,18,33,348,260,88,297,89,208,64,44,8,0,75.05,11.05,1,
2016,Arizona Cardinals,Away,San Francisco 49ers,33,21,288,116,172,286,135,151,75,34,16,0,75.05,0.05,1,
2016,Arizona Cardinals,Away,Carolina Panthers,20,30,340,316,24,349,208,141,85,53,5,0,75.05,9.95,1,
2016,Arizona Cardinals,Away,Minnesota Vikings,24,30,290,155,135,217,145,72,68,70,0,0,75.05,7.05,0,
2016,Arizona Cardinals,Home,Washington Redskins,31,23,369,281,88,333,246,87,68,13,0,0,75.05,7.05,1,
2016,Arizona Cardinals,Away,Miami Dolphins,23,26,300,125,175,314,231,83,77,87,18,0,75.05,1.95,1,
2016,Arizona Cardinals,Home,New Orleans Saints,41,48,425,309,116,488,358,130,62,20,2,0,75.05,13.05,1,
2016,Arizona Cardinals,Away,Seattle Seahawks,34,31,370,276,94,391,313,78,39,87,2,0,75.05,36.05,1,
2015,Arizona Cardinals,Away,Chicago Bears,48,23,300,185,115,335,226,109,70,47,6,0,75.05,5.05,1,
2015,Arizona Cardinals,Away,Detroit Lions,42,17,345,158,187,435,379,56,68,70,0,0,75.05,7.05,1,
2015,Arizona Cardinals,Away,Pittsburgh Steelers,13,25,469,414,55,310,169,141,45,47,12,0,75.05,30.05,1,
2015,Arizona Cardinals,Away,Cleveland Browns,34,20,491,372,119,254,215,39,62,58,21,0,75.05,13.05,1,
2015,Arizona Cardinals,Away,Seattle Seahawks,39,32,451,334,117,343,228,115,49,63,0,0,75.05,26.05,1,
2015,Arizona Cardinals,Home,Cincinnati Bengals,34,31,383,301,82,377,278,99,72,22,7,0,75.05,3.05,1,
2015,Arizona Cardinals,Away,San Francisco 49ers,19,13,337,267,70,368,301,67,54,40,4,0,75.05,21.05,1,
2015,Arizona Cardinals,Home,Minnesota Vikings,23,20,393,296,97,389,317,72,68,26,1,0,75.05,7.05,1,
2015,Arizona Cardinals,Away,Philadelphia Eagles,40,17,493,263,230,424,350,74,37,54,4,0,75.05,38.05,1,
2018,Atlanta Falcons,Away,Philadelphia Eagles,12,18,299,225,74,232,119,113,81,71,8,0,62.55,18.45,1,
2018,Atlanta Falcons,Away,Pittsburgh Steelers,17,41,324,262,62,381,250,131,83,69,5,0,62.55,20.45,1,
2018,Atlanta Falcons,Home,New York Giants,23,20,423,356,67,433,372,61,60,49,2,0,62.55,2.55,1,
2018,Atlanta Falcons,Away,Washington Redskins,38,14,491,337,154,366,287,79,55,46,5,0,62.55,7.55,1,
2018,Atlanta Falcons,Away,Cleveland Browns,16,28,382,311,71,427,216,211,36,56,9,0,62.55,26.55,1,
2018,Atlanta Falcons,Home,Dallas Cowboys,19,22,354,274,80,323,191,132,59,57,1,0,62.55,3.55,1,
2018,Atlanta Falcons,Away,New Orleans Saints,17,31,366,340,26,312,162,150,53,72,5,0,62.55,9.55,1,
2018,Atlanta Falcons,Home,Baltimore Ravens,16,26,131,97,34,366,159,207,67,44,9,0,62.55,4.45,1,
2018,Atlanta Falcons,Away,Green Bay Packers,20,34,344,237,107,300,162,138,25,70,10,0,62.55,37.55,1,
2018,Atlanta Falcons,Away,Carolina Panthers,24,10,427,233,194,436,295,141,52,45,7,0,62.55,10.55,1,
2018,Atlanta Falcons,Away,Tampa Bay Buccaneers,34,32,489,380,109,433,341,92,80,73,5,0,62.55,17.45,1,
2017,Atlanta Falcons,Away,Chicago Bears,23,17,372,308,64,301,176,125,64,57,10,0,62.55,1.45,1,
2017,Atlanta Falcons,Home,Green Bay Packers,34,23,364,223,141,367,308,59,78,72,4,0,62.55,15.45,1,
2017,Atlanta Falcons,Away,Detroit Lions,30,26,428,277,151,324,253,71,68,70,0,0,62.55,5.45,1,
2017,Atlanta Falcons,Home,Miami Dolphins,17,20,339,239,100,289,151,138,68,70,0,0,62.55,5.45,0,
2017,Atlanta Falcons,Away,New England Patriots,7,23,343,223,120,403,241,162,56,88,2,0,62.55,6.55,1,
2017,Atlanta Falcons,Away,New York Jets,25,20,386,246,140,279,236,43,63,93,5,1,62.55,0.45,1,
2017,Atlanta Falcons,Away,Carolina Panthers,17,20,355,302,53,330,129,201,61,86,4,0,62.55,1.55,1,
2017,Atlanta Falcons,Away,Seattle Seahawks,34,31,279,190,89,360,224,136,45,85,6,0,62.55,17.55,1,
2017,Atlanta Falcons,Away,Tampa Bay Buccaneers,24,21,410,209,201,373,289,84,71,85,2,0,62.55,8.45,1,
2017,Atlanta Falcons,Away,New Orleans Saints,13,23,331,264,67,315,229,86,56,71,4,0,62.55,6.55,1,
2016,Atlanta Falcons,Away,Oakland Raiders,35,28,528,389,139,454,299,155,79,41,7,0,62.55,16.45,1,
2016,Atlanta Falcons,Away,New Orleans Saints,45,32,442,225,217,474,359,115,90,53,4,0,62.55,27.45,1,
2016,Atlanta Falcons,Away,Denver Broncos,23,16,372,250,122,267,183,84,72,18,5,0,62.55,9.45,1,
2016,Atlanta Falcons,Away,Seattle Seahawks,24,26,362,310,52,333,261,72,54,83,10,1,62.55,8.55,1,
2016,Atlanta Falcons,Away,Tampa Bay Buccaneers,43,28,461,325,136,396,326,70,76,70,2,0,62.55,13.45,1,
2016,Atlanta Falcons,Away,Philadelphia Eagles,15,24,303,255,48,429,221,208,58,37,10,0,62.55,4.55,1,
2016,Atlanta Falcons,Away,Los Angeles Rams,42,14,286,220,66,312,208,104,65,73,1,0,62.55,2.45,1,
2016,Atlanta Falcons,Away,Carolina Panthers,33,16,408,256,152,302,183,119,56,58,5,0,62.55,6.55,1,
2015,Atlanta Falcons,Home,Philadelphia Eagles,26,24,395,290,105,399,336,63,68,70,0,0,62.55,5.45,0,
2015,Atlanta Falcons,Away,New York Giants,24,20,402,346,56,388,291,97,73,47,9,0,62.55,10.45,1,
2015,Atlanta Falcons,Away,New Orleans Saints,21,31,413,263,150,385,304,81,83,33,9,0,62.55,20.45,1,
2015,Atlanta Falcons,Away,Tennessee Titans,10,7,378,251,127,256,179,77,59,95,8,0,62.55,3.55,1,
2015,Atlanta Falcons,Away,San Francisco 49ers,16,17,302,285,17,318,185,133,58,84,0,0,62.55,4.55,1,
2015,Atlanta Falcons,Away,Tampa Bay Buccaneers,19,23,319,255,64,388,222,166,79,63,18,0,62.55,16.45,1,
2015,Atlanta Falcons,Away,Carolina Panthers,0,38,230,176,54,424,282,142,63,93,6,0,62.55,0.45,1,
2015,Atlanta Falcons,Away,Jacksonville Jaguars,23,17,328,245,83,370,285,85,65,60,8,0,62.55,2.45,1,
2015,Atlanta Falcons,Home,Carolina Panthers,20,13,373,296,77,268,113,155,68,70,0,0,62.55,5.45,1,
2018,Baltimore Ravens,Home,Buffalo Bills,47,3,369,252,117,153,70,83,61,97,12,1,40.72,20.28,1,
2018,Baltimore Ravens,Away,Cincinnati Bengals,23,34,425,359,66,373,265,108,82,54,3,0,40.72,41.28,1,
2018,Baltimore Ravens,Home,Denver Broncos,27,14,342,265,77,293,173,120,61,91,5,1,40.72,20.28,1,
2018,Baltimore Ravens,Away,Pittsburgh Steelers,26,14,451,355,96,284,265,19,69,86,2,0,40.72,28.28,1,
2018,Baltimore Ravens,Away,Cleveland Browns,9,12,410,294,116,416,304,112,72,89,5,0,40.72,31.28,1,
2018,Baltimore Ravens,Away,Tennessee Titans,21,0,361,238,123,106,51,55,66,100,4,1,40.72,25.28,1,
2018,Baltimore Ravens,Home,New Orleans Saints,23,24,351,274,77,339,205,134,54,34,15,0,40.72,13.28,1,
2018,Baltimore Ravens,Away,Carolina Panthers,21,36,325,224,101,386,232,154,61,65,10,0,40.72,20.28,1,
2018,Baltimore Ravens,Home,Pittsburgh Steelers,16,23,265,204,61,395,282,113,55,45,6,0,40.72,14.28,1,
2018,Baltimore Ravens,Home,Cincinnati Bengals,24,21,403,136,267,255,207,48,48,58,8,0,40.72,7.28,1,
2018,Baltimore Ravens,Home,Oakland Raiders,34,17,416,174,242,249,182,67,60,54,7,0,40.72,19.28,1,
2018,Baltimore Ravens,Away,Atlanta Falcons,26,16,366,159,207,131,97,34,67,44,9,0,40.72,26.28,1,
2018,Baltimore Ravens,Away,Kansas City Chiefs,24,27,321,127,194,442,348,94,27,72,0,0,40.72,13.72,1,
2018,Baltimore Ravens,Home,Tampa Bay Buccaneers,20,12,370,128,242,241,156,85,43,97,15,0,40.72,2.28,1,
2018,Baltimore Ravens,Away,Los Angeles Chargers,22,10,361,202,159,198,147,51,60,89,5,0,40.72,19.28,1,
2018,Baltimore Ravens,Home,Cleveland Browns,26,24,463,167,296,426,376,50,48,59,2,0,40.72,7.28,1,
2017,Baltimore Ravens,Away,Cincinnati Bengals,20,0,268,111,157,221,144,77,68,43,9,0,40.72,27.28,1,
2017,Baltimore Ravens,Home,Cleveland Browns,24,10,337,201,136,386,293,93,80,69,2,0,40.72,39.28,1,
2017,Baltimore Ravens,Away,Jacksonville Jaguars,7,44,186,52,134,410,244,166,70,51,10,0,40.72,29.28,1,
2017,Baltimore Ravens,Home,Pittsburgh Steelers,9,26,288,206,82,381,208,173,64,52,6,0,40.72,23.28,1,
2017,Baltimore Ravens,Away,Oakland Raiders,30,17,365,222,143,245,137,108,72,42,8,0,40.72,31.28,1,
2017,Baltimore Ravens,Home,Chicago Bears,24,27,291,166,125,342,111,231,69,87,7,0,40.72,28.28,1,
2017,Baltimore Ravens,Away,Minnesota Vikings,16,24,208,144,64,357,188,169,68,70,0,0,40.72,27.28,0,
2017,Baltimore Ravens,Home,Miami Dolphins,40,0,295,121,174,196,151,45,56,49,9,0,40.72,15.28,1,
2017,Baltimore Ravens,Away,Tennessee Titans,20,23,341,268,73,257,186,71,75,66,10,0,40.72,34.28,1,
2017,Baltimore Ravens,Away,Green Bay Packers,23,0,219,161,58,265,190,75,28,63,14,0,40.72,12.72,1,
2017,Baltimore Ravens,Home,Houston Texans,23,16,294,155,139,303,237,66,50,60,1,0,40.72,9.28,1,
2017,Baltimore Ravens,Home,Detroit Lions,44,20,370,269,101,372,294,78,53,70,4,0,40.72,12.28,1,
2017,Baltimore Ravens,Away,Pittsburgh Steelers,38,39,413,261,152,545,486,59,33,55,12,0,40.72,7.72,1,
2017,Baltimore Ravens,Away,Cleveland Browns,27,10,376,279,97,266,136,130,36,78,0,0,40.72,4.72,1,
2017,Baltimore Ravens,Home,Indianapolis Colts,23,16,323,220,103,296,203,93,63,78,14,0,40.72,22.28,1,
2017,Baltimore Ravens,Home,Cincinnati Bengals,27,31,312,194,118,359,213,146,19,36,12,0,40.72,21.72,1,
2016,Baltimore Ravens,Away,Cincinnati Bengals,10,27,335,263,72,371,218,153,40,95,6,0,40.72,0.72,1,
2016,Baltimore Ravens,Home,Buffalo Bills,13,7,308,225,83,160,95,65,84,44,8,0,40.72,43.28,1,
2016,Baltimore Ravens,Away,Cleveland Browns,25,20,382,302,80,387,242,145,74,70,7,0,40.72,33.28,1,
2016,Baltimore Ravens,Away,Jacksonville Jaguars,19,17,283,199,84,216,168,48,88,50,8,0,40.72,47.28,1,
2016,Baltimore Ravens,Home,Oakland Raiders,27,28,412,282,130,261,199,62,65,84,2,0,40.72,24.28,1,
2016,Baltimore Ravens,Home,Washington Redskins,10,16,306,188,118,310,250,60,62,53,16,0,40.72,21.28,1,
2016,Baltimore Ravens,Away,New York Giants,23,27,391,293,98,435,397,38,65,66,6,0,40.72,24.28,1,
2016,Baltimore Ravens,Away,New York Jets,16,24,245,234,11,344,189,155,58,38,36,0,40.72,17.28,1,
2016,Baltimore Ravens,Home,Pittsburgh Steelers,21,14,274,224,50,277,241,36,65,28,15,0,40.72,24.28,1,
2016,Baltimore Ravens,Home,Cleveland Browns,28,7,396,277,119,144,111,33,58,48,3,0,40.72,17.28,1,
2016,Baltimore Ravens,Home,Cincinnati Bengals,19,14,311,219,92,325,261,64,50,37,12,0,40.72,9.28,1,
2016,Baltimore Ravens,Home,Miami Dolphins,38,6,496,386,110,277,215,62,47,67,3,0,40.72,6.28,1,
2016,Baltimore Ravens,Away,New England Patriots,23,30,348,306,42,496,401,95,31,91,3,0,40.72,9.72,1,
2016,Baltimore Ravens,Home,Philadelphia Eagles,27,26,340,189,151,328,159,169,62,77,9,0,40.72,21.28,1,
2016,Baltimore Ravens,Away,Pittsburgh Steelers,27,31,368,246,122,406,279,127,41,73,9,0,40.72,0.28,1,
2015,Baltimore Ravens,Away,Cincinnati Bengals,16,24,341,282,59,292,147,145,35,67,7,0,40.72,5.72,1,
2015,Baltimore Ravens,Away,Denver Broncos,13,19,173,100,73,219,150,69,88,8,13,0,40.72,47.28,1,
2015,Baltimore Ravens,Away,Oakland Raiders,33,37,493,384,109,448,351,97,80,32,8,0,40.72,39.28,1,
2015,Baltimore Ravens,Home,Cincinnati Bengals,24,28,398,362,36,458,372,86,70,20,12,0,40.72,29.28,1,
2015,Baltimore Ravens,Away,Pittsburgh Steelers,23,20,356,165,191,263,96,167,63,62,8,0,40.72,22.28,1,
2015,Baltimore Ravens,Home,Cleveland Browns,30,33,377,196,181,505,422,83,65,48,2,0,40.72,24.28,1,
2015,Baltimore Ravens,Away,San Francisco 49ers,20,25,420,343,77,391,326,65,69,60,7,0,40.72,28.28,1,
2015,Baltimore Ravens,Home,San Diego Chargers,29,26,365,293,72,371,290,81,63,72,10,0,40.72,22.28,1,
2015,Baltimore Ravens,Home,Jacksonville Jaguars,20,22,397,308,89,258,168,90,60,34,10,0,40.72,19.28,1,
2015,Baltimore Ravens,Home,St. Louis Rams,16,13,388,292,96,213,131,82,47,39,18,0,40.72,6.28,1,
2015,Baltimore Ravens,Away,Cleveland Browns,33,27,336,232,104,338,275,63,45,58,9,0,40.72,4.28,1,
2015,Baltimore Ravens,Away,Miami Dolphins,13,15,375,281,94,219,82,137,80,70,21,0,40.72,39.28,1,
2015,Baltimore Ravens,Home,Seattle Seahawks,6,35,302,274,28,424,301,123,65,70,2,0,40.72,24.28,1,
2015,Baltimore Ravens,Home,Kansas City Chiefs,14,34,366,273,93,277,164,113,41,35,5,0,40.72,0.28,1,
2015,Baltimore Ravens,Home,Pittsburgh Steelers,20,17,386,265,121,308,198,110,64,87,9,0,40.72,23.28,1,
2018,Buffalo Bills,Away,Baltimore Ravens,3,47,153,70,83,369,252,117,61,97,12,1,48.25,12.75,1,
2018,Buffalo Bills,Home,Los Angeles Chargers,20,31,293,209,84,349,240,109,83,63,6,0,48.25,34.75,1,
2018,Buffalo Bills,Away,Minnesota Vikings,27,6,292,164,128,292,278,14,68,70,0,0,48.25,19.75,0,
2018,Buffalo Bills,Away,Green Bay Packers,0,22,145,87,58,423,282,141,49,79,9,0,48.25,0.75,1,
2018,Buffalo Bills,Home,Tennessee Titans,13,12,223,79,144,221,121,100,62,96,8,0,48.25,13.75,1,
2018,Buffalo Bills,Away,Houston Texans,13,20,229,129,100,216,142,74,87,60,9,0,48.25,38.75,1,
2018,Buffalo Bills,Away,Indianapolis Colts,5,37,303,168,135,376,156,220,44,56,3,0,48.25,4.25,1,
2018,Buffalo Bills,Home,New England Patriots,6,25,333,287,46,387,311,76,46,58,16,0,48.25,2.25,1,
2018,Buffalo Bills,Home,Chicago Bears,9,41,264,166,98,190,126,64,49,56,12,0,48.25,0.75,1,
2018,Buffalo Bills,Away,New York Jets,41,10,451,239,212,199,116,83,46,39,10,0,48.25,2.25,1,
2018,Buffalo Bills,Home,Jacksonville Jaguars,24,21,327,160,167,333,107,226,44,79,12,0,48.25,4.25,1,
2018,Buffalo Bills,Away,Miami Dolphins,17,21,415,217,198,175,115,60,86,68,15,0,48.25,37.75,1,
2018,Buffalo Bills,Home,New York Jets,23,27,368,192,176,248,170,78,31,63,12,0,48.25,17.25,1,
2018,Buffalo Bills,Home,Detroit Lions,14,13,312,195,117,313,208,105,39,85,7,1,48.25,9.25,1,
2018,Buffalo Bills,Away,New England Patriots,12,24,289,217,72,390,117,273,40,38,12,0,48.25,8.25,1,
2018,Buffalo Bills,Home,Miami Dolphins,42,17,381,215,166,225,126,99,33,75,9,0,48.25,15.25,1,
2017,Buffalo Bills,Home,New York Jets,21,12,408,218,190,214,176,38,65,53,5,0,48.25,16.75,1,
2017,Buffalo Bills,Away,Carolina Panthers,3,9,176,107,69,255,178,77,83,60,5,0,48.25,34.75,1,
2017,Buffalo Bills,Home,Denver Broncos,26,16,272,197,75,366,255,111,83,56,5,0,48.25,34.75,1,
2017,Buffalo Bills,Away,Cincinnati Bengals,16,20,221,139,82,388,323,65,63,90,10,0,48.25,14.75,1,
2017,Buffalo Bills,Home,Tampa Bay Buccaneers,30,27,434,261,173,447,378,69,74,45,9,0,48.25,25.75,1,
2017,Buffalo Bills,Home,Oakland Raiders,34,14,331,165,166,367,313,54,42,94,7,1,48.25,6.25,1,
2017,Buffalo Bills,Away,New York Jets,21,34,307,244,63,331,137,194,68,70,11,0,48.25,19.75,1,
2017,Buffalo Bills,Home,New Orleans Saints,10,47,198,129,69,482,184,298,42,50,2,0,48.25,6.25,1,
2017,Buffalo Bills,Away,Los Angeles Chargers,24,54,393,220,173,429,283,146,76,24,6,0,48.25,27.75,1,
2017,Buffalo Bills,Away,Kansas City Chiefs,16,10,268,164,104,236,181,55,62,36,9,0,48.25,13.75,1,
2017,Buffalo Bills,Home,New England Patriots,3,23,268,85,183,435,244,191,48,73,13,0,48.25,0.25,1,
2017,Buffalo Bills,Home,Indianapolis Colts,13,7,319,92,227,227,64,163,32,69,15,1,48.25,16.25,1,
2017,Buffalo Bills,Home,Miami Dolphins,24,16,328,212,116,349,249,100,22,71,8,0,48.25,26.25,1,
2017,Buffalo Bills,Away,New England Patriots,16,37,326,242,84,411,218,193,35,67,7,0,48.25,13.25,1,
2017,Buffalo Bills,Away,Miami Dolphins,22,16,312,186,126,356,263,93,71,66,9,0,48.25,22.75,1,
2016,Buffalo Bills,Away,New York Jets,10,30,230,162,68,329,202,127,42,38,11,0,48.25,6.25,1,
2016,Buffalo Bills,Away,Baltimore Ravens,7,13,160,95,65,308,225,83,84,44,8,0,48.25,35.75,1,
2016,Buffalo Bills,Home,New York Jets,31,37,393,307,86,493,370,123,60,65,11,0,48.25,11.75,1,
2016,Buffalo Bills,Home,Arizona Cardinals,33,18,297,89,208,348,260,88,64,44,8,0,48.25,15.75,1,
2016,Buffalo Bills,Away,New England Patriots,16,0,378,244,134,277,187,90,56,91,7,0,48.25,7.75,1,
2016,Buffalo Bills,Away,Los Angeles Rams,30,19,305,112,193,345,243,102,91,18,5,0,48.25,42.75,1,
2016,Buffalo Bills,Home,San Francisco 49ers,45,16,492,179,313,300,167,133,71,62,22,0,48.25,22.75,1,
2016,Buffalo Bills,Away,Miami Dolphins,25,28,267,200,67,454,198,256,81,48,11,0,48.25,32.75,1,
2016,Buffalo Bills,Home,New England Patriots,25,41,376,209,167,357,285,72,49,92,9,1,48.25,0.75,1,
2016,Buffalo Bills,Away,Seattle Seahawks,25,31,425,263,162,278,245,33,61,40,4,0,48.25,12.75,1,
2016,Buffalo Bills,Away,Cincinnati Bengals,16,12,342,159,183,300,207,93,36,59,8,0,48.25,12.25,1,
2016,Buffalo Bills,Home,Jacksonville Jaguars,28,21,304,151,153,301,118,183,42,65,13,0,48.25,6.25,1,
2016,Buffalo Bills,Away,Oakland Raiders,24,38,382,170,212,399,260,139,59,70,4,0,48.25,10.75,1,
2016,Buffalo Bills,Home,Pittsburgh Steelers,20,27,275,208,67,460,220,240,27,75,9,1,48.25,21.25,1,
2016,Buffalo Bills,Home,Cleveland Browns,33,13,451,171,280,269,162,107,26,69,15,0,48.25,22.25,1,
2016,Buffalo Bills,Home,Miami Dolphins,31,34,589,317,272,494,233,261,38,86,13,0,48.25,10.25,1,
2015,Buffalo Bills,Home,New York Jets,22,17,295,182,113,300,178,122,35,70,21,0,48.25,13.25,1,
2015,Buffalo Bills,Home,Indianapolis Colts,27,14,342,195,147,304,240,64,56,78,15,0,48.25,7.75,1,
2015,Buffalo Bills,Home,New England Patriots,32,40,349,189,160,507,451,56,52,67,10,0,48.25,3.75,1,
2015,Buffalo Bills,Away,Miami Dolphins,41,14,428,277,151,391,289,102,87,65,6,0,48.25,38.75,1,
2015,Buffalo Bills,Home,New York Giants,10,24,313,258,55,303,211,92,60,66,8,0,48.25,11.75,1,
2015,Buffalo Bills,Away,Tennessee Titans,14,13,209,82,127,276,179,97,67,58,5,0,48.25,18.75,1,
2015,Buffalo Bills,Home,Cincinnati Bengals,21,34,368,256,112,355,243,112,40,73,4,0,48.25,8.25,1,
2015,Buffalo Bills,Away,Jacksonville Jaguars,31,34,375,260,115,295,175,120,48,74,2,0,48.25,0.25,1,
2015,Buffalo Bills,Home,Miami Dolphins,33,17,420,154,266,397,289,108,49,55,7,0,48.25,0.75,1,
2015,Buffalo Bills,Away,New York Jets,22,17,280,132,148,318,190,128,60,75,16,0,48.25,11.75,1,
2015,Buffalo Bills,Away,New England Patriots,13,20,319,225,94,356,271,85,29,40,8,0,48.25,19.25,1,
2015,Buffalo Bills,Away,Kansas City Chiefs,22,30,415,286,129,413,255,158,35,99,7,1,48.25,13.25,1,
2015,Buffalo Bills,Home,Houston Texans,30,21,390,203,187,401,275,126,47,65,8,0,48.25,1.25,1,
2015,Buffalo Bills,Away,Philadelphia Eagles,20,23,412,260,152,348,232,116,66,68,3,0,48.25,17.75,1,
2015,Buffalo Bills,Away,Washington Redskins,25,35,452,212,240,431,308,123,43,30,3,0,48.25,5.25,1,
2015,Buffalo Bills,Home,Dallas Cowboys,16,6,408,172,236,307,186,121,39,83,11,1,48.25,9.25,1,
2018,Carolina Panthers,Home,Dallas Cowboys,16,8,293,146,147,232,138,94,81,74,9,0,59.8,21.2,1,
2018,Carolina Panthers,Home,Cincinnati Bengals,31,21,377,147,230,396,330,66,80,69,3,0,59.8,20.2,1,
2018,Carolina Panthers,Home,New York Giants,33,31,350,232,118,432,382,50,80,83,3,0,59.8,20.2,1,
2018,Carolina Panthers,Away,Washington Redskins,17,23,350,269,81,288,156,132,52,74,0,0,59.8,7.8,1,
2018,Carolina Panthers,Away,Philadelphia Eagles,21,17,371,250,121,342,284,58,49,41,19,0,59.8,10.8,1,
2018,Carolina Panthers,Home,Baltimore Ravens,36,21,386,232,154,325,224,101,61,65,10,0,59.8,1.2,1,
2018,Carolina Panthers,Home,Tampa Bay Buccaneers,42,28,407,228,179,301,219,82,62,47,8,0,59.8,2.2,1,
2018,Carolina Panthers,Away,Pittsburgh Steelers,21,52,242,147,95,457,319,138,40,76,4,0,59.8,19.8,1,
2018,Carolina Panthers,Away,Detroit Lions,19,20,387,331,56,309,215,94,69,70,0,0,59.8,9.2,1,
2018,Carolina Panthers,Home,Seattle Seahawks,27,30,476,256,220,397,322,75,57,63,1,0,59.8,2.8,1,
2018,Carolina Panthers,Away,Tampa Bay Buccaneers,17,24,444,276,168,315,220,95,81,75,15,0,59.8,21.2,1,
2018,Carolina Panthers,Away,Cleveland Browns,20,26,393,297,96,348,232,116,28,60,4,0,59.8,31.8,1,
2018,Carolina Panthers,Home,New Orleans Saints,9,12,247,149,98,346,191,155,48,45,3,0,59.8,11.8,1,
2018,Carolina Panthers,Home,Atlanta Falcons,10,24,436,295,141,427,233,194,52,45,7,0,59.8,7.8,1,
2018,Carolina Panthers,Away,New Orleans Saints,33,14,374,263,111,294,110,184,64,98,5,0,59.8,4.2,1,
2017,Carolina Panthers,Away,San Francisco 49ers,23,3,287,171,116,217,166,51,87,43,8,0,59.8,27.2,1,
2017,Carolina Panthers,Home,Buffalo Bills,9,3,255,178,77,176,107,69,83,60,5,0,59.8,23.2,1,
2017,Carolina Panthers,Home,New Orleans Saints,13,34,288,156,132,362,213,149,82,59,6,0,59.8,22.2,1,
2017,Carolina Panthers,Away,New England Patriots,33,30,444,304,140,373,293,80,61,43,6,0,59.8,1.2,1,
2017,Carolina Panthers,Away,Detroit Lions,27,24,362,334,28,242,192,50,68,70,0,0,59.8,8.2,1,
2017,Carolina Panthers,Home,Philadelphia Eagles,23,28,305,225,80,310,209,101,72,88,6,0,59.8,12.2,1,
2017,Carolina Panthers,Away,Chicago Bears,3,17,293,185,108,153,85,68,70,100,15,1,59.8,10.2,1,
2017,Carolina Panthers,Away,Tampa Bay Buccaneers,17,3,254,154,100,279,194,85,63,63,13,0,59.8,3.2,1,
2017,Carolina Panthers,Home,Atlanta Falcons,20,17,330,129,201,355,302,53,61,86,4,0,59.8,1.2,1,
2017,Carolina Panthers,Home,Miami Dolphins,45,21,548,254,294,313,213,100,49,66,6,0,59.8,10.8,1,
2017,Carolina Panthers,Away,New York Jets,35,27,299,154,145,391,282,109,47,42,18,0,59.8,12.8,1,
2017,Carolina Panthers,Away,New Orleans Saints,21,31,279,167,112,400,252,148,69,66,7,0,59.8,9.2,1,
2017,Carolina Panthers,Home,Minnesota Vikings,31,24,345,129,216,356,256,100,41,49,5,0,59.8,18.8,1,
2017,Carolina Panthers,Home,Green Bay Packers,31,24,387,236,151,384,264,120,51,55,5,0,59.8,8.8,1,
2017,Carolina Panthers,Home,Tampa Bay Buccaneers,22,19,255,140,115,392,326,66,55,63,6,0,59.8,4.8,1,
2016,Carolina Panthers,Away,Tampa Bay Buccaneers,16,17,335,207,128,300,188,112,81,65,6,0,59.8,21.2,1,
2016,Carolina Panthers,Away,Denver Broncos,20,21,333,176,157,307,159,148,85,12,10,0,59.8,25.2,1,
2016,Carolina Panthers,Home,San Francisco 49ers,46,27,529,353,176,302,237,65,82,60,4,0,59.8,22.2,1,
2016,Carolina Panthers,Home,Minnesota Vikings,10,22,306,201,105,211,153,58,80,63,0,0,59.8,20.2,1,
2016,Carolina Panthers,Home,Tampa Bay Buccaneers,14,17,414,278,136,315,202,113,66,35,7,0,59.8,6.2,1,
2016,Carolina Panthers,Away,New Orleans Saints,38,41,406,303,103,523,460,63,80,75,7,0,59.8,20.2,1,
2016,Carolina Panthers,Home,Arizona Cardinals,30,20,349,208,141,340,316,24,85,53,5,0,59.8,25.2,1,
2016,Carolina Panthers,Away,Los Angeles Rams,13,10,244,185,59,339,280,59,75,49,2,0,59.8,15.2,1,
2016,Carolina Panthers,Home,Kansas City Chiefs,17,20,341,242,99,256,165,91,45,76,6,0,59.8,14.8,1,
2016,Carolina Panthers,Home,New Orleans Saints,23,20,223,173,50,371,264,107,63,43,6,0,59.8,3.2,1,
2016,Carolina Panthers,Away,Oakland Raiders,32,35,358,229,129,366,310,56,59,55,12,0,59.8,0.8,1,
2016,Carolina Panthers,Away,Seattle Seahawks,7,40,271,182,89,534,294,240,37,71,4,0,59.8,22.8,1,
2016,Carolina Panthers,Home,San Diego Chargers,28,16,272,146,126,278,220,58,37,49,6,0,59.8,22.8,1,
2016,Carolina Panthers,Away,Washington Redskins,26,15,438,290,148,335,306,29,32,56,8,0,59.8,27.8,1,
2016,Carolina Panthers,Home,Atlanta Falcons,16,33,302,183,119,408,256,152,56,58,5,0,59.8,3.8,1,
2015,Carolina Panthers,Home,Tampa Bay Buccaneers,38,10,366,255,111,386,309,77,54,31,4,0,59.8,5.8,1,
2015,Carolina Panthers,Away,Jacksonville Jaguars,20,9,263,158,105,265,169,96,77,55,7,0,59.8,17.2,1,
2015,Carolina Panthers,Home,Houston Texans,24,17,350,178,172,300,239,61,88,43,6,0,59.8,28.2,1,
2015,Carolina Panthers,Home,New Orleans Saints,27,22,431,312,119,380,310,70,69,90,9,0,59.8,9.2,1,
2015,Carolina Panthers,Away,Tampa Bay Buccaneers,37,23,244,111,133,411,270,141,74,92,5,0,59.8,14.2,1,
2015,Carolina Panthers,Away,Seattle Seahawks,27,23,383,248,135,334,219,115,61,85,5,0,59.8,1.2,1,
2015,Carolina Panthers,Home,Philadelphia Eagles,27,16,394,190,204,349,172,177,71,80,0,0,59.8,11.2,1,
2015,Carolina Panthers,Home,Indianapolis Colts,29,26,379,239,140,359,223,136,60,100,7,1,59.8,0.2,1,
2015,Carolina Panthers,Home,Green Bay Packers,37,29,427,297,130,402,331,71,57,50,10,0,59.8,2.8,1,
2015,Carolina Panthers,Away,Tennessee Titans,27,10,303,184,119,242,178,64,57,24,2,0,59.8,2.8,1,
2015,Carolina Panthers,Home,Washington Redskins,44,16,368,226,142,186,172,14,50,63,8,0,59.8,9.8,1,
2015,Carolina Panthers,Away,New Orleans Saints,41,38,497,322,175,334,264,70,69,60,7,0,59.8,9.2,1,
2015,Carolina Panthers,Home,Atlanta Falcons,38,0,424,282,142,230,176,54,63,93,6,0,59.8,3.2,1,
2015,Carolina Panthers,Away,New York Giants,38,35,480,309,171,406,245,161,41,37,8,0,59.8,18.8,1,
2015,Carolina Panthers,Away,Atlanta Falcons,13,20,268,113,155,373,296,77,68,70,0,0,59.8,8.2,1,
2018,Chicago Bears,Away,Green Bay Packers,23,24,294,155,139,370,301,69,62,65,10,0,51.3,10.7,1,
2018,Chicago Bears,Home,Seattle Seahawks,24,17,271,185,86,276,202,74,79,62,2,0,51.3,27.7,1,
2018,Chicago Bears,Away,Arizona Cardinals,16,14,316,194,122,221,168,53,68,70,0,0,51.3,16.7,0,
2018,Chicago Bears,Home,Tampa Bay Buccaneers,48,10,483,344,139,311,251,60,66,62,5,0,51.3,14.7,1,
2018,Chicago Bears,Away,Miami Dolphins,28,31,467,303,164,541,380,161,89,67,8,0,51.3,37.7,1,
2018,Chicago Bears,Home,New England Patriots,31,38,453,319,134,381,273,108,44,42,9,0,51.3,7.3,1,
2018,Chicago Bears,Home,New York Jets,24,10,395,216,179,207,150,57,48,71,18,0,51.3,3.3,1,
2018,Chicago Bears,Away,Buffalo Bills,41,9,190,126,64,264,166,98,49,56,12,0,51.3,2.3,1,
2018,Chicago Bears,Home,Detroit Lions,34,22,402,348,54,305,229,76,37,52,12,0,51.3,14.3,1,
2018,Chicago Bears,Home,Minnesota Vikings,25,20,308,160,148,268,246,22,33,77,6,0,51.3,18.3,1,
2018,Chicago Bears,Away,Detroit Lions,23,16,264,226,38,333,222,111,68,70,0,0,51.3,16.7,1,
2018,Chicago Bears,Away,New York Giants,27,30,376,258,118,338,197,141,52,92,3,0,51.3,0.7,1,
2018,Chicago Bears,Home,Los Angeles Rams,15,6,294,100,194,214,162,52,29,70,4,0,51.3,22.3,1,
2018,Chicago Bears,Home,Green Bay Packers,24,17,332,232,100,323,235,88,45,63,10,0,51.3,6.3,1,
2018,Chicago Bears,Away,San Francisco 49ers,14,9,325,235,90,279,232,47,50,76,5,0,51.3,1.3,1,
2018,Chicago Bears,Away,Minnesota Vikings,24,10,332,163,169,164,101,63,68,70,0,0,51.3,16.7,0,
2017,Chicago Bears,Home,Atlanta Falcons,17,23,301,176,125,372,308,64,64,57,10,0,51.3,12.7,1,
2017,Chicago Bears,Away,Tampa Bay Buccaneers,7,29,310,290,20,311,194,117,88,62,7,0,51.3,36.7,1,
2017,Chicago Bears,Home,Pittsburgh Steelers,23,17,306,84,222,282,212,70,89,48,5,0,51.3,37.7,1,
2017,Chicago Bears,Away,Green Bay Packers,14,35,308,205,103,260,169,91,65,62,5,0,51.3,13.7,1,
2017,Chicago Bears,Home,Minnesota Vikings,17,20,274,159,115,300,141,159,70,69,10,0,51.3,18.7,1,
2017,Chicago Bears,Away,Baltimore Ravens,27,24,342,111,231,291,166,125,69,87,7,0,51.3,17.7,1,
2017,Chicago Bears,Home,Carolina Panthers,17,3,153,85,68,293,185,108,74,56,12,0,51.3,22.7,1,
2017,Chicago Bears,Away,New Orleans Saints,12,20,307,150,157,387,286,101,54,47,4,0,51.3,2.7,1,
2017,Chicago Bears,Home,Green Bay Packers,16,23,323,268,55,342,182,160,39,89,6,1,51.3,12.3,1,
2017,Chicago Bears,Home,Detroit Lions,24,27,398,176,222,352,287,65,33,60,16,0,51.3,18.3,1,
2017,Chicago Bears,Away,Philadelphia Eagles,3,31,140,134,6,420,244,176,49,42,17,0,51.3,2.3,1,
2017,Chicago Bears,Home,San Francisco 49ers,14,15,147,85,62,388,278,110,54,44,6,0,51.3,2.7,1,
2017,Chicago Bears,Away,Cincinnati Bengals,33,7,482,250,232,234,164,70,31,64,11,0,51.3,20.3,1,
2017,Chicago Bears,Away,Detroit Lions,10,20,349,306,43,293,202,91,68,70,0,0,51.3,16.7,1,
2017,Chicago Bears,Home,Cleveland Browns,20,3,258,161,97,254,178,76,24,83,8,1,51.3,27.3,1,
2017,Chicago Bears,Away,Minnesota Vikings,10,23,201,171,30,327,180,147,68,70,0,0,51.3,16.7,0,
2016,Chicago Bears,Away,Minnesota Vikings,10,38,323,140,183,374,250,124,68,70,0,0,51.3,16.7,0,
2016,Chicago Bears,Away,Houston Texans,14,23,258,185,73,344,215,129,84,61,3,0,51.3,32.7,1,
2016,Chicago Bears,Home,Philadelphia Eagles,14,29,284,220,64,280,180,100,84,36,5,0,51.3,32.7,1,
2016,Chicago Bears,Home,Detroit Lions,17,14,408,294,114,263,197,66,62,84,6,0,51.3,10.7,1,
2016,Chicago Bears,Away,Indianapolis Colts,23,29,522,397,125,396,298,98,60,59,5,0,51.3,8.7,1,
2016,Chicago Bears,Home,Jacksonville Jaguars,16,17,389,297,92,317,263,54,69,93,7,0,51.3,17.7,1,
2016,Chicago Bears,Away,Green Bay Packers,10,26,189,120,69,406,303,103,47,63,10,0,51.3,4.3,1,
2016,Chicago Bears,Home,Minnesota Vikings,20,10,403,245,158,258,201,57,58,71,12,0,51.3,6.7,1,
2016,Chicago Bears,Away,Tampa Bay Buccaneers,10,36,283,161,122,360,280,80,81,61,4,0,51.3,29.7,1,
2016,Chicago Bears,Away,New York Giants,16,22,315,222,93,329,227,102,41,76,10,0,51.3,10.3,1,
2016,Chicago Bears,Home,Tennessee Titans,21,27,411,316,95,375,226,149,40,88,11,0,51.3,11.3,1,
2016,Chicago Bears,Home,San Francisco 49ers,26,6,326,184,142,147,6,141,33,91,5,1,51.3,18.3,1,
2016,Chicago Bears,Away,Detroit Lions,17,20,296,204,92,323,209,114,68,70,0,0,51.3,16.7,1,
2016,Chicago Bears,Home,Green Bay Packers,27,30,449,354,95,451,225,226,11,57,12,0,51.3,40.3,1,
2016,Chicago Bears,Home,Washington Redskins,21,41,458,318,140,478,270,208,37,79,1,0,51.3,14.3,1,
2015,Chicago Bears,Home,Detroit Lions,20,24,345,234,111,349,282,67,31,67,15,0,51.3,20.3,1,
2015,Chicago Bears,Home,Green Bay Packers,23,31,402,213,189,322,189,133,68,39,11,0,51.3,16.7,1,
2015,Chicago Bears,Home,Arizona Cardinals,23,48,335,226,109,300,185,115,70,47,6,0,51.3,18.7,1,
2015,Chicago Bears,Away,Seattle Seahawks,0,26,146,48,98,371,212,159,60,53,5,0,51.3,8.7,1,
2015,Chicago Bears,Home,Oakland Raiders,22,20,371,273,98,266,196,70,55,83,12,0,51.3,3.7,1,
2015,Chicago Bears,Away,Kansas City Chiefs,18,17,328,241,87,287,170,117,72,51,10,0,51.3,20.7,1,
2015,Chicago Bears,Away,Detroit Lions,34,37,444,353,91,546,391,155,68,70,0,0,51.3,16.7,1,
2015,Chicago Bears,Home,Minnesota Vikings,20,23,305,208,97,327,180,147,62,42,11,0,51.3,10.7,1,
2015,Chicago Bears,Away,San Diego Chargers,22,19,446,337,109,339,262,77,63,67,9,0,51.3,11.7,1,
2015,Chicago Bears,Home,Denver Broncos,15,17,347,261,86,389,219,170,29,57,9,0,51.3,22.3,1,
2015,Chicago Bears,Away,Green Bay Packers,17,13,290,189,101,365,188,177,39,92,19,1,51.3,12.3,1,
2015,Chicago Bears,Home,San Francisco 49ers,20,26,364,194,170,291,170,121,50,55,5,0,51.3,1.3,1,
2015,Chicago Bears,Home,Washington Redskins,21,24,377,290,87,374,275,99,62,80,12,1,51.3,10.7,1,
2015,Chicago Bears,Away,Minnesota Vikings,17,38,293,199,94,350,221,129,36,50,3,0,51.3,15.3,1,
2015,Chicago Bears,Away,Tampa Bay Buccaneers,26,21,327,153,174,389,285,104,83,59,13,0,51.3,31.7,1,
2018,Cinncinnati Bengals,Away,Indianapolis Colts,34,23,330,229,101,380,305,75,59,91,11,0,54.65,4.35,1,
2018,Cinncinnati Bengals,Home,Baltimore Ravens,34,23,373,265,108,425,359,66,82,54,3,0,54.65,27.35,1,
2018,Cinncinnati Bengals,Away,Carolina Panthers,21,31,396,330,66,377,147,230,80,69,3,0,54.65,25.35,1,
2018,Cinncinnati Bengals,Home,Miami Dolphins,27,17,332,229,103,297,169,128,87,52,4,0,54.65,32.35,1,
2018,Cinncinnati Bengals,Home,Pittsburgh Steelers,21,28,275,213,62,481,369,112,51,93,6,0,54.65,3.65,1,
2018,Cinncinnati Bengals,Away,Kansas City Chiefs,10,45,239,174,65,551,353,198,59,42,10,0,54.65,4.35,1,
2018,Cinncinnati Bengals,Home,Tampa Bay Buccaneers,37,34,402,264,138,576,450,126,50,55,77,0,54.65,4.65,1,
2018,Cinncinnati Bengals,Home,New Orleans Saints,14,51,284,174,110,509,265,244,39,51,6,0,54.65,15.65,1,
2018,Cinncinnati Bengals,Away,Baltimore Ravens,21,24,255,207,48,403,136,267,48,58,8,0,54.65,6.65,1,
2018,Cinncinnati Bengals,Home,Cleveland Browns,20,35,372,243,129,342,258,84,44,100,4,0,54.65,10.65,1,
2018,Cinncinnati Bengals,Home,Denver Broncos,10,24,313,202,111,361,143,218,63,49,12,0,54.65,8.35,1,
2018,Cinncinnati Bengals,Away,Los Angeles Chargers,21,26,295,151,144,288,203,85,71,42,2,0,54.65,16.35,1,
2018,Cinncinnati Bengals,Home,Oakland Raiders,30,16,294,123,171,297,229,68,43,96,2,0,54.65,11.65,1,
2018,Cinncinnati Bengals,Away,Cleveland Browns,18,26,209,107,102,493,347,146,37,76,9,0,54.65,17.65,1,
2018,Cinncinnati Bengals,Away,Pittsburgh Steelers,13,16,196,71,125,343,278,65,42,63,9,0,54.65,12.65,1,
2017,Cinncinnati Bengals,Home,Baltimore Ravens,0,20,221,144,77,268,111,157,68,43,9,0,54.65,13.35,1,
2017,Cinncinnati Bengals,Home,Houston Texans,9,13,295,213,82,266,98,168,69,78,2,0,54.65,14.35,1,
2017,Cinncinnati Bengals,Away,Green Bay Packers,24,27,301,191,110,344,280,64,89,44,4,0,54.65,34.35,1,
2017,Cinncinnati Bengals,Away,Cleveland Browns,31,7,350,264,86,215,170,45,63,37,6,0,54.65,8.35,1,
2017,Cinncinnati Bengals,Home,Buffalo Bills,20,16,388,323,65,221,139,82,63,90,10,0,54.65,8.35,1,
2017,Cinncinnati Bengals,Away,Pittsburgh Steelers,14,29,179,108,71,420,268,152,79,37,6,0,54.65,24.35,1,
2017,Cinncinnati Bengals,Home,Indianapolis Colts,24,23,276,218,58,331,216,115,39,68,9,0,54.65,15.65,1,
2017,Cinncinnati Bengals,Away,Jacksonville Jaguars,7,23,148,119,29,408,259,149,78,74,12,0,54.65,23.35,1,
2017,Cinncinnati Bengals,Away,Tennessee Titans,20,24,308,255,53,416,236,180,53,88,4,0,54.65,1.65,1,
2017,Cinncinnati Bengals,Away,Denver Broncos,20,17,190,141,49,341,229,112,60,10,7,0,54.65,5.35,1,
2017,Cinncinnati Bengals,Home,Cleveland Browns,30,16,361,209,152,405,236,169,46,52,3,0,54.65,8.65,1,
2017,Cinncinnati Bengals,Home,Pittsburgh Steelers,20,23,353,223,130,374,282,92,61,44,9,1,54.65,6.35,1,
2017,Cinncinnati Bengals,Home,Chicago Bears,7,33,234,164,70,482,250,232,31,64,11,0,54.65,23.65,1,
2017,Cinncinnati Bengals,Away,Minnesota Vikings,7,34,161,115,46,346,222,124,68,70,0,0,54.65,13.35,0,
2017,Cinncinnati Bengals,Home,Detroit Lions,26,17,364,222,142,276,189,87,35,76,2,0,54.65,19.65,1,
2017,Cinncinnati Bengals,Away,Baltimore Ravens,31,27,359,213,146,312,194,118,19,36,12,0,54.65,35.65,1,
2016,Cinncinnati Bengals,Home,Baltimore Ravens,27,10,371,218,153,335,263,72,40,95,6,0,54.65,14.65,1,
2016,Cinncinnati Bengals,Away,New York Jets,23,22,381,324,57,340,188,152,79,40,20,0,54.65,24.35,1,
2016,Cinncinnati Bengals,Away,Pittsburgh Steelers,16,24,412,366,46,374,250,124,72,86,4,0,54.65,17.35,1,
2016,Cinncinnati Bengals,Home,Denver Broncos,17,29,332,189,143,355,303,52,81,53,3,0,54.65,26.35,1,
2016,Cinncinnati Bengals,Home,Miami Dolphins,22,7,362,285,77,222,160,62,62,77,2,0,54.65,7.35,1,
2016,Cinncinnati Bengals,Away,New England Patriots,17,35,357,237,120,437,358,79,66,54,14,0,54.65,11.35,1,
2016,Cinncinnati Bengals,Home,Cleveland Browns,31,17,559,288,271,352,172,180,65,50,5,0,54.65,10.35,1,
2016,Cinncinnati Bengals,Home,Washington Redskins,27,27,415,263,152,546,446,100,54,90,2,0,54.65,0.65,1,
2016,Cinncinnati Bengals,Away,New York Giants,20,21,264,186,78,351,229,122,56,35,2,0,54.65,1.35,1,
2016,Cinncinnati Bengals,Home,Buffalo Bills,12,16,300,207,93,342,159,183,36,59,8,0,54.65,18.65,1,
2016,Cinncinnati Bengals,Away,Baltimore Ravens,14,19,325,261,64,311,219,92,50,37,12,0,54.65,4.65,1,
2016,Cinncinnati Bengals,Home,Philadelphia Eagles,32,14,412,332,80,359,306,53,42,61,10,0,54.65,12.65,1,
2016,Cinncinnati Bengals,Away,Cleveland Browns,23,10,360,147,213,254,85,169,28,78,15,1,54.65,26.65,1,
2016,Cinncinnati Bengals,Home,Pittsburgh Steelers,20,24,222,146,76,382,285,97,24,86,8,0,54.65,30.65,1,
2016,Cinncinnati Bengals,Away,Houston Texans,10,12,294,244,50,250,155,95,71,86,10,0,54.65,16.35,1,
2015,Cinncinnati Bengals,Home,Baltimore Ravens,24,16,292,147,145,341,282,59,35,67,7,0,54.65,19.65,1,
2015,Cinncinnati Bengals,Away,Oakland Raiders,33,13,396,269,127,246,183,63,73,59,9,0,54.65,18.35,1,
2015,Cinncinnati Bengals,Home,San Diego Chargers,24,19,389,214,175,354,223,131,69,47,6,0,54.65,14.35,1,
2015,Cinncinnati Bengals,Away,Baltimore Ravens,28,24,458,372,86,398,362,36,70,20,12,0,54.65,15.35,1,
2015,Cinncinnati Bengals,Home,Kansas City Chiefs,36,21,445,321,124,461,348,113,68,64,5,0,54.65,13.35,1,
2015,Cinncinnati Bengals,Home,Seattle Seahawks,27,24,419,310,109,397,197,200,66,59,3,0,54.65,11.35,1,
2015,Cinncinnati Bengals,Away,Buffalo Bills,34,21,355,243,112,368,256,112,40,73,4,0,54.65,14.65,1,
2015,Cinncinnati Bengals,Away,Pittsburgh Steelers,16,10,296,218,78,356,240,116,62,71,11,0,54.65,7.35,1,
2015,Cinncinnati Bengals,Home,Cleveland Browns,31,10,371,219,152,213,144,69,71,61,4,0,54.65,16.35,1,
2015,Cinncinnati Bengals,Home,Houston Texans,6,10,256,182,74,256,174,82,53,60,4,1,54.65,1.65,1,
2015,Cinncinnati Bengals,Away,Arizona Cardinals,31,34,377,278,99,383,301,82,72,22,7,0,54.65,17.35,1,
2015,Cinncinnati Bengals,Home,St. Louis Rams,31,7,376,236,140,345,251,94,41,88,8,0,54.65,13.65,1,
2015,Cinncinnati Bengals,Away,Cleveland Browns,37,3,377,233,144,273,205,68,45,63,12,0,54.65,9.65,1,
2015,Cinncinnati Bengals,Home,Pittsburgh Steelers,20,33,385,321,64,354,270,84,63,79,8,0,54.65,8.35,1,
2015,Cinncinnati Bengals,Away,San Francisco 49ers,24,14,242,174,68,318,263,55,52,63,14,0,54.65,2.65,1,
2015,Cinncinnati Bengals,Away,Denver Broncos,17,20,294,186,108,390,277,113,16,75,6,0,54.65,38.65,1,
2018,Cleveland Browns,Home,Pittsburgh Steelers,21,21,327,150,177,472,313,159,58,84,11,1,51.35,6.65,1,
2018,Cleveland Browns,Away,New Orleans Saints,18,21,327,234,93,275,213,62,90,68,1,0,51.35,38.65,1,
2018,Cleveland Browns,Home,New York Jets,21,17,323,190,133,268,161,107,83,64,11,0,51.35,31.65,1,
2018,Cleveland Browns,Away,Oakland Raiders,42,45,487,279,208,565,426,139,71,58,8,0,51.35,19.65,1,
2018,Cleveland Browns,Home,Baltimore Ravens,12,9,416,304,112,410,294,116,72,89,5,0,51.35,20.65,1,
2018,Cleveland Browns,Home,Los Angeles Chargers,14,38,317,214,103,449,203,246,51,61,9,0,51.35,0.35,1,
2018,Cleveland Browns,Away,Tampa Bay Buccaneers,23,26,305,186,119,456,342,114,79,64,7,0,51.35,27.65,1,
2018,Cleveland Browns,Away,Pittsburgh Steelers,18,33,237,163,74,421,253,168,47,79,11,0,51.35,4.35,1,
2018,Cleveland Browns,Home,Kansas City Chiefs,21,37,388,286,102,499,360,139,53,49,16,0,51.35,1.65,1,
2018,Cleveland Browns,Home,Atlanta Falcons,28,16,427,216,211,382,311,71,36,56,9,0,51.35,15.35,1,
2018,Cleveland Browns,Away,Cincinnati Bengals,35,20,342,258,84,372,243,129,44,100,4,0,51.35,7.35,1,
2018,Cleveland Browns,Away,Houston Texans,13,29,428,397,31,384,197,187,72,28,7,0,51.35,20.65,1,
2018,Cleveland Browns,Home,Carolina Panthers,26,20,348,232,116,393,297,96,28,60,4,0,51.35,23.35,1,
2018,Cleveland Browns,Away,Denver Broncos,17,16,309,175,134,270,238,32,46,35,0,0,51.35,5.35,1,
2018,Cleveland Browns,Home,Cincinnati Bengals,26,18,493,347,146,209,107,102,37,76,9,0,51.35,14.35,1,
2018,Cleveland Browns,Away,Baltimore Ravens,24,26,426,376,50,463,167,296,48,59,2,0,51.35,3.35,1,
2017,Cleveland Browns,Home,Pittsburgh Steelers,18,21,237,180,57,290,255,35,63,53,12,0,51.35,11.65,1,
2017,Cleveland Browns,Away,Baltimore Ravens,10,24,386,293,93,337,201,136,80,69,2,0,51.35,28.65,1,
2017,Cleveland Browns,Away,Indianapolis Colts,28,31,346,235,111,335,243,92,83,45,5,0,51.35,31.65,1,
2017,Cleveland Browns,Home,Cincinnati Bengals,7,31,215,170,45,350,264,86,63,37,6,0,51.35,11.65,1,
2017,Cleveland Browns,Home,New York Jets,14,17,419,279,140,212,178,34,67,71,8,0,51.35,15.65,1,
2017,Cleveland Browns,Away,Houston Texans,17,33,247,113,134,340,217,123,85,62,7,0,51.35,33.65,1,
2017,Cleveland Browns,Home,Tennessee Titans,9,12,284,218,66,269,189,80,70,100,15,1,51.35,18.65,1,
2017,Cleveland Browns,Home,Minnesota Vikings,16,33,276,161,115,375,287,88,56,56,11,0,51.35,4.65,1,
2017,Cleveland Browns,Away,Detroit Lions,24,38,413,212,201,345,241,104,68,70,0,0,51.35,16.65,1,
2017,Cleveland Browns,Home,Jacksonville Jaguars,7,19,184,134,50,284,145,139,38,68,16,0,51.35,13.35,1,
2017,Cleveland Browns,Away,Cincinnati Bengals,16,30,405,236,169,361,209,152,46,52,3,0,51.35,5.35,1,
2017,Cleveland Browns,Away,Los Angeles Chargers,10,19,291,202,89,429,335,94,68,63,7,0,51.35,16.65,1,
2017,Cleveland Browns,Home,Green Bay Packers,21,27,345,209,136,341,256,85,29,58,24,0,51.35,22.35,1,
2017,Cleveland Browns,Home,Baltimore Ravens,10,27,266,136,130,376,279,97,36,78,0,0,51.35,15.35,1,
2017,Cleveland Browns,Away,Chicago Bears,3,20,254,178,76,258,161,97,24,83,8,1,51.35,27.35,1,
2017,Cleveland Browns,Away,Pittsburgh Steelers,24,28,374,272,102,348,224,124,11,80,3,1,51.35,40.35,1,
2016,Cleveland Browns,Away,Pittsburgh Steelers,24,27,437,206,231,312,243,69,41,64,1,0,51.35,10.35,1,
2016,Cleveland Browns,Away,Philadelphia Eagles,10,29,288,168,120,403,270,133,85,42,14,0,51.35,33.65,1,
2016,Cleveland Browns,Home,Baltimore Ravens,20,25,387,242,145,382,302,80,74,70,7,0,51.35,22.65,1,
2016,Cleveland Browns,Away,Miami Dolphins,24,30,430,261,169,426,311,115,86,65,16,0,51.35,34.65,1,
2016,Cleveland Browns,Away,Washington Redskins,20,31,380,217,163,301,156,145,67,89,1,0,51.35,15.65,1,
2016,Cleveland Browns,Home,New England Patriots,13,33,262,235,27,501,403,98,58,58,13,0,51.35,6.65,1,
2016,Cleveland Browns,Away,Tennessee Titans,26,28,341,301,40,407,270,137,75,70,10,0,51.35,23.65,1,
2016,Cleveland Browns,Away,Cincinnati Bengals,17,31,352,172,180,559,288,271,65,50,5,0,51.35,13.65,1,
2016,Cleveland Browns,Home,New York Jets,28,31,407,339,68,393,222,171,53,91,15,1,51.35,1.65,1,
2016,Cleveland Browns,Home,Dallas Cowboys,10,35,222,177,45,423,255,168,58,73,4,0,51.35,6.65,1,
2016,Cleveland Browns,Away,Baltimore Ravens,7,28,144,111,33,396,277,119,58,48,3,0,51.35,6.65,1,
2016,Cleveland Browns,Home,Pittsburgh Steelers,9,24,209,176,33,313,167,146,36,64,27,0,51.35,15.35,1,
2016,Cleveland Browns,Home,New York Giants,13,27,343,285,58,296,192,104,48,58,10,0,51.35,3.35,1,
2016,Cleveland Browns,Home,Cincinnati Bengals,10,23,254,85,169,360,147,213,28,78,15,1,51.35,23.35,1,
2016,Cleveland Browns,Away,Buffalo Bills,13,33,269,162,107,451,171,280,26,69,15,0,51.35,25.35,1,
2016,Cleveland Browns,Home,San Diego Chargers,20,17,251,127,124,356,322,34,38,89,13,0,51.35,13.35,1,
2015,Cleveland Browns,Home,Pittsburgh Steelers,12,28,263,177,86,379,349,30,34,75,18,0,51.35,17.35,1,
2015,Cleveland Browns,Away,New York Jets,10,31,321,217,104,333,179,154,77,49,8,0,51.35,25.65,1,
2015,Cleveland Browns,Home,Tennessee Titans,28,14,274,158,116,385,219,166,64,59,12,0,51.35,12.65,1,
2015,Cleveland Browns,Home,Oakland Raiders,20,27,355,316,39,469,314,155,75,62,15,0,51.35,23.65,1,
2015,Cleveland Browns,Away,San Diego Chargers,27,30,432,332,100,438,347,91,68,78,11,0,51.35,16.65,1,
2015,Cleveland Browns,Away,Baltimore Ravens,33,30,505,422,83,377,196,181,65,48,2,0,51.35,13.65,1,
2015,Cleveland Browns,Home,Denver Broncos,23,26,298,189,109,442,290,152,47,52,20,0,51.35,4.35,1,
2015,Cleveland Browns,Home,Arizona Cardinals,20,34,254,215,39,491,372,119,62,58,21,0,51.35,10.65,1,
2015,Cleveland Browns,Away,Cincinnati Bengals,10,31,213,144,69,371,219,152,71,61,4,0,51.35,19.65,1,
2015,Cleveland Browns,Away,Pittsburgh Steelers,9,30,342,327,15,459,399,60,61,32,12,0,51.35,9.65,1,
2015,Cleveland Browns,Home,Baltimore Ravens,27,33,338,275,63,336,232,104,45,58,9,0,51.35,6.35,1,
2015,Cleveland Browns,Home,Cincinnati Bengals,3,37,273,205,68,377,233,144,45,63,12,0,51.35,6.35,1,
2015,Cleveland Browns,Home,San Francisco 49ers,24,10,481,251,230,221,150,71,63,79,11,0,51.35,11.65,1,
2015,Cleveland Browns,Away,Seattle Seahawks,13,30,230,136,94,423,241,182,47,56,10,0,51.35,4.35,1,
2015,Cleveland Browns,Away,Kansas City Chiefs,13,17,368,136,232,258,122,136,36,91,16,0,51.35,15.35,1,
2018,Dallas Cowboys,Away,Carolina Panthers,8,16,232,138,94,293,146,147,81,74,9,0,64.3,16.7,1,
2018,Dallas Cowboys,Away,Seattle Seahawks,13,24,303,137,166,295,182,113,61,59,4,0,64.3,3.3,1,
2018,Dallas Cowboys,Away,Houston Texans,16,19,292,194,98,462,374,88,83,70,7,0,64.3,18.7,1,
2018,Dallas Cowboys,Away,Washington Redskins,17,20,323,250,73,305,175,130,52,43,12,0,64.3,12.3,1,
2018,Dallas Cowboys,Home,Tennessee Titans,14,28,297,225,72,340,215,125,74,58,4,0,64.3,9.7,1,
2018,Dallas Cowboys,Away,Philadelphia Eagles,27,20,410,239,171,421,350,71,38,62,5,0,64.3,26.3,1,
2018,Dallas Cowboys,Away,Atlanta Falcons,22,19,323,191,132,354,274,80,59,57,1,0,64.3,5.3,1,
2018,Dallas Cowboys,Home,New Orleans Saints,13,10,308,209,99,176,111,65,70,59,10,0,64.3,5.7,1,
2018,Dallas Cowboys,Home,Philadelphia Eagles,29,23,576,434,142,256,222,34,51,55,10,0,64.3,13.3,1,
2018,Dallas Cowboys,Away,Indianapolis Colts,0,23,292,180,112,370,192,178,46,80,5,0,64.3,18.3,1,
2018,Dallas Cowboys,Away,New York Giants,36,35,419,368,51,441,298,143,37,70,2,0,64.3,27.3,1,
2017,Dallas Cowboys,Away,Denver Broncos,17,42,268,228,40,380,202,178,72,41,5,0,64.3,7.7,1,
2017,Dallas Cowboys,Away,Arizona Cardinals,28,17,273,174,99,332,283,49,68,70,0,0,64.3,3.7,0,
2017,Dallas Cowboys,Away,San Francisco 49ers,40,10,501,236,265,290,187,103,68,60,10,0,64.3,3.7,1,
2017,Dallas Cowboys,Away,Washington Redskins,33,19,307,138,169,285,236,49,60,93,4,1,64.3,4.3,1,
2017,Dallas Cowboys,Home,Philadelphia Eagles,9,37,225,113,112,383,168,215,54,36,0,0,64.3,10.3,1,
2017,Dallas Cowboys,Home,Washington Redskins,38,14,275,93,182,280,224,56,58,56,3,0,64.3,6.3,1,
2017,Dallas Cowboys,Away,New York Giants,30,10,454,332,122,330,228,102,39,55,11,0,64.3,25.3,1,
2017,Dallas Cowboys,Away,Oakland Raiders,20,17,330,204,126,293,171,122,57,37,4,0,64.3,7.3,1,
2017,Dallas Cowboys,Away,Philadelphia Eagles,6,0,301,172,129,219,149,70,19,30,17,0,64.3,45.3,1,
2016,Dallas Cowboys,Away,Philadelphia Eagles,13,27,195,126,69,346,232,114,50,38,10,0,64.3,14.3,1,
2016,Dallas Cowboys,Away,Washington Redskins,27,23,380,278,102,432,350,82,81,65,6,0,64.3,16.7,1,
2016,Dallas Cowboys,Away,San Francisco 49ers,24,17,428,234,194,295,189,106,68,60,10,0,64.3,3.7,1,
2016,Dallas Cowboys,Away,Green Bay Packers,30,16,424,233,191,372,294,78,69,63,8,0,64.3,4.7,1,
2016,Dallas Cowboys,Home,Philadelphia Eagles,29,23,460,273,187,291,194,97,84,44,5,0,64.3,19.7,1,
2016,Dallas Cowboys,Away,Cleveland Browns,35,10,423,255,168,222,177,45,58,73,4,0,64.3,6.3,1,
2016,Dallas Cowboys,Away,Pittsburgh Steelers,35,30,422,295,127,448,400,48,56,29,7,0,64.3,8.3,1,
2016,Dallas Cowboys,Away,Minnesota Vikings,17,15,264,124,140,318,231,87,68,70,0,0,64.3,3.7,0,
2016,Dallas Cowboys,Away,New York Giants,7,10,260,152,108,260,167,93,32,95,0,0,64.3,32.3,1,
2015,Dallas Cowboys,Away,Philadelphia Eagles,20,10,359,250,109,226,219,7,77,37,15,0,64.3,12.7,1,
2015,Dallas Cowboys,Away,New Orleans Saints,20,26,335,220,115,438,335,103,67,67,12,0,64.3,2.7,1,
2015,Dallas Cowboys,Away,New York Giants,20,27,460,227,233,289,157,132,70,41,14,0,64.3,5.7,1,
2015,Dallas Cowboys,Home,Philadelphia Eagles,27,33,411,277,134,459,287,172,60,43,5,0,64.3,4.3,1,
2015,Dallas Cowboys,Away,Tampa Bay Buccaneers,6,10,216,174,42,330,246,84,79,56,13,0,64.3,14.7,1,
2015,Dallas Cowboys,Away,Miami Dolphins,24,14,386,220,166,210,140,70,74,90,10,0,64.3,9.7,1,
2015,Dallas Cowboys,Away,Washington Redskins,19,16,318,221,97,266,193,73,41,75,0,0,64.3,23.3,1,
2015,Dallas Cowboys,Away,Green Bay Packers,7,28,270,99,171,435,205,230,53,100,10,1,64.3,11.3,1,
2015,Dallas Cowboys,Home,New York Jets,16,19,309,176,133,372,299,73,61,39,9,0,64.3,3.3,1,
2015,Dallas Cowboys,Away,Buffalo Bills,6,16,307,186,121,408,172,236,39,83,11,1,64.3,25.3,1,
2018,Denver Broncos,Home,Seattle Seahawks,27,24,470,324,146,306,242,64,84,17,5,0,50.7,33.3,1,
2018,Denver Broncos,Home,Oakland Raiders,20,19,385,217,168,373,281,92,92,13,4,0,50.7,41.3,1,
2018,Denver Broncos,Away,Baltimore Ravens,14,27,293,173,120,342,265,77,61,91,5,1,50.7,10.3,1,
2018,Denver Broncos,Home,Kansas City Chiefs,23,27,385,226,159,446,304,142,65,51,5,0,50.7,14.3,1,
2018,Denver Broncos,Away,New York Jets,16,34,436,344,92,512,189,323,77,79,7,0,50.7,26.3,1,
2018,Denver Broncos,Home,Los Angeles Rams,20,23,357,297,60,444,174,270,25,76,6,0,50.7,25.7,1,
2018,Denver Broncos,Away,Arizona Cardinals,45,10,309,178,131,223,154,69,82,27,6,0,50.7,31.3,1,
2018,Denver Broncos,Away,Kansas City Chiefs,23,30,411,222,189,340,291,49,56,45,12,0,50.7,5.3,1,
2018,Denver Broncos,Home,Houston Texans,17,19,348,273,75,290,192,98,53,34,3,0,50.7,2.3,1,
2018,Denver Broncos,Away,Los Angeles Chargers,23,22,325,217,108,479,384,95,69,67,4,0,50.7,18.3,1,
2018,Denver Broncos,Home,Pittsburgh Steelers,24,17,308,184,124,527,452,75,41,26,7,0,50.7,9.7,1,
2018,Denver Broncos,Away,Cincinnati Bengals,24,10,361,143,218,313,202,111,63,49,12,0,50.7,12.3,1,
2018,Denver Broncos,Away,San Francisco 49ers,14,20,274,171,103,389,305,84,54,72,3,0,50.7,3.3,1,
2018,Denver Broncos,Home,Cleveland Browns,16,17,270,238,32,309,175,134,46,35,0,0,50.7,4.7,1,
2018,Denver Broncos,Away,Oakland Raiders,14,27,300,200,100,273,159,114,58,80,14,1,50.7,7.3,1,
2018,Denver Broncos,Home,Los Angeles Chargers,9,23,370,288,82,276,160,116,51,22,6,0,50.7,0.3,1,
2017,Denver Broncos,Home,Los Angeles Chargers,24,21,321,181,140,249,185,64,73,39,12,0,50.7,22.3,1,
2017,Denver Broncos,Home,Dallas Cowboys,42,17,380,202,178,268,228,40,72,41,5,0,50.7,21.3,1,
2017,Denver Broncos,Away,Buffalo Bills,16,26,366,255,111,272,197,75,83,56,5,0,50.7,32.3,1,
2017,Denver Broncos,Home,Oakland Raiders,16,10,298,155,143,254,230,24,72,26,7,0,50.7,21.3,1,
2017,Denver Broncos,Home,New York Giants,10,23,412,366,46,266,118,148,61,17,4,0,50.7,10.3,1,
2017,Denver Broncos,Away,Los Angeles Chargers,0,21,251,182,69,242,162,80,90,15,4,0,50.7,39.3,1,
2017,Denver Broncos,Away,Kansas City Chiefs,19,29,364,187,177,276,197,79,44,41,12,0,50.7,6.7,1,
2017,Denver Broncos,Away,Philadelphia Eagles,23,51,226,191,35,419,222,197,61,89,5,0,50.7,10.3,1,
2017,Denver Broncos,Home,New England Patriots,16,41,339,221,118,396,297,99,48,40,5,0,50.7,2.7,1,
2017,Denver Broncos,Home,Cincinnati Bengals,17,20,341,229,112,190,141,49,60,10,7,0,50.7,9.3,1,
2017,Denver Broncos,Away,Oakland Raiders,14,21,216,160,56,348,244,104,61,95,13,0,50.7,10.3,1,
2017,Denver Broncos,Away,Miami Dolphins,9,35,270,167,103,367,222,145,80,58,11,0,50.7,29.3,1,
2017,Denver Broncos,Home,New York Jets,23,0,273,189,84,100,41,59,60,8,3,0,50.7,9.3,1,
2017,Denver Broncos,Away,Indianapolis Colts,25,13,462,251,211,228,158,70,25,62,5,0,50.7,25.7,1,
2017,Denver Broncos,Away,Washington Redskins,11,27,330,171,159,386,299,87,43,59,7,0,50.7,7.7,1,
2017,Denver Broncos,Home,Kansas City Chiefs,24,27,336,226,110,379,269,110,17,76,4,0,50.7,33.7,1,
2016,Denver Broncos,Home,Oakland Raiders,24,6,349,206,143,221,164,57,40,95,6,0,50.7,10.7,1,
2016,Denver Broncos,Home,Carolina Panthers,21,20,307,159,148,333,176,157,85,12,10,0,50.7,34.3,1,
2016,Denver Broncos,Home,Indianapolis Colts,34,20,400,266,134,253,170,83,85,15,4,0,50.7,34.3,1,
2016,Denver Broncos,Away,Cincinnati Bengals,29,17,355,303,52,332,189,143,81,53,3,0,50.7,30.3,1,
2016,Denver Broncos,Away,Tampa Bay Buccaneers,27,7,307,218,89,215,143,72,88,63,7,0,50.7,37.3,1,
2016,Denver Broncos,Home,Atlanta Falcons,16,23,267,183,84,372,250,122,72,18,5,0,50.7,21.3,1,
2016,Denver Broncos,Away,San Diego Chargers,13,21,304,220,84,265,166,99,70,63,9,0,50.7,19.3,1,
2016,Denver Broncos,Home,Houston Texans,27,9,347,157,190,271,131,140,71,17,5,0,50.7,20.3,1,
2016,Denver Broncos,Home,San Diego Chargers,27,19,324,267,57,369,246,123,76,19,15,0,50.7,25.3,1,
2016,Denver Broncos,Away,Oakland Raiders,20,30,299,266,33,397,179,218,65,79,6,0,50.7,14.3,1,
2016,Denver Broncos,Away,New Orleans Saints,25,23,337,234,103,373,293,80,62,62,6,0,50.7,11.3,1,
2016,Denver Broncos,Home,Kansas City Chiefs,27,30,464,340,124,273,190,83,44,25,15,0,50.7,6.7,1,
2016,Denver Broncos,Away,Jacksonville Jaguars,20,10,206,102,104,333,179,154,70,70,10,0,50.7,19.3,1,
2016,Denver Broncos,Away,Tennessee Titans,10,13,348,330,18,253,73,180,50,37,5,0,50.7,0.7,1,
2016,Denver Broncos,Home,New England Patriots,3,16,309,251,58,313,177,136,18,52,9,0,50.7,32.7,1,
2016,Denver Broncos,Away,Kansas City Chiefs,10,33,246,183,63,484,246,238,53,80,9,1,50.7,2.3,1,
2015,Denver Broncos,Home,San Diego Chargers,27,20,503,293,210,317,207,110,50,21,5,0,50.7,0.7,1,
2015,Denver Broncos,Home,Baltimore Ravens,19,13,219,150,69,173,100,73,88,8,13,0,50.7,37.3,1,
2015,Denver Broncos,Away,Kansas City Chiefs,31,24,299,238,61,314,167,147,87,59,13,0,50.7,36.3,1,
2015,Denver Broncos,Away,Detroit Lions,24,12,354,313,41,290,262,28,68,70,0,0,50.7,17.3,1,
2015,Denver Broncos,Home,Minnesota Vikings,23,20,344,200,144,325,212,113,60,57,9,0,50.7,9.3,1,
2015,Denver Broncos,Away,Oakland Raiders,16,10,297,254,43,288,223,65,72,59,10,0,50.7,21.3,1,
2015,Denver Broncos,Away,Cleveland Browns,26,23,442,290,152,298,189,109,47,52,20,0,50.7,3.7,1,
2015,Denver Broncos,Home,Green Bay Packers,29,10,500,340,160,140,50,90,62,23,9,0,50.7,11.3,1,
2015,Denver Broncos,Away,Indianapolis Colts,24,27,309,274,35,365,245,120,54,32,5,0,50.7,3.3,1,
2015,Denver Broncos,Home,Kansas City Chiefs,13,29,221,152,69,303,197,106,64,10,5,0,50.7,13.3,1,
2015,Denver Broncos,Away,Chicago Bears,17,15,389,219,170,347,261,86,29,57,9,0,50.7,21.7,1,
2015,Denver Broncos,Home,New England Patriots,30,24,433,254,179,301,262,39,23,75,3,1,50.7,27.7,1,
2015,Denver Broncos,Away,San Diego Chargers,17,3,293,159,134,272,179,93,78,13,4,0,50.7,27.3,1,
2015,Denver Broncos,Home,Oakland Raiders,12,15,310,276,34,126,99,27,45,33,2,0,50.7,5.7,1,
2015,Denver Broncos,Away,Pittsburgh Steelers,27,34,385,281,104,377,354,23,41,35,8,0,50.7,9.7,1,
2015,Denver Broncos,Home,Cincinnati Bengals,20,17,390,277,113,294,186,108,16,75,6,0,50.7,34.7,1,
2018,Detroit Lions,Home,New York Jets,17,48,339,300,39,349,180,169,68,70,0,0,48.7,19.3,1,
2018,Detroit Lions,Away,San Francisco 49ers,27,30,427,329,98,346,156,190,73,12,0,0,48.7,24.3,1,
2018,Detroit Lions,Home,New England Patriots,26,10,414,255,159,209,120,89,68,70,0,0,48.7,19.3,1,
2018,Detroit Lions,Home,Green Bay Packers,31,23,264,170,94,521,423,98,68,70,0,0,48.7,19.3,1,
2018,Detroit Lions,Away,Miami Dolphins,32,21,457,209,248,322,215,107,89,51,8,0,48.7,40.3,1,
2018,Detroit Lions,Home,Seattle Seahawks,14,28,331,297,34,413,237,176,68,70,0,0,48.7,19.3,1,
2018,Detroit Lions,Away,Minnesota Vikings,9,24,209,143,66,283,155,128,68,70,0,0,48.7,19.3,0,
2018,Detroit Lions,Away,Chicago Bears,22,34,305,229,76,402,348,54,37,52,12,0,48.7,11.7,1,
2018,Detroit Lions,Home,Carolina Panthers,20,19,309,215,94,387,331,56,69,70,0,0,48.7,20.3,1,
2018,Detroit Lions,Home,Chicago Bears,16,23,333,222,111,264,226,38,68,70,0,0,48.7,19.3,1,
2018,Detroit Lions,Home,Los Angeles Rams,16,30,310,208,102,344,195,149,68,70,0,0,48.7,19.3,1,
2018,Detroit Lions,Away,Arizona Cardinals,17,3,218,96,122,279,218,61,70,41,2,0,48.7,21.3,1,
2018,Detroit Lions,Away,Buffalo Bills,13,14,313,208,105,312,195,117,39,85,7,1,48.7,9.7,1,
2018,Detroit Lions,Home,Minnesota Vikings,9,27,223,137,86,340,240,100,68,70,0,0,48.7,19.3,1,
2018,Detroit Lions,Away,Green Bay Packers,31,0,402,272,130,175,129,46,26,70,15,0,48.7,22.7,1,
2017,Detroit Lions,Home,Arizona Cardinals,35,23,367,285,82,308,263,45,68,70,0,0,48.7,19.3,1,
2017,Detroit Lions,Away,New York Giants,24,10,257,119,138,270,208,62,72,80,5,0,48.7,23.3,1,
2017,Detroit Lions,Home,Atlanta Falcons,26,30,324,253,71,428,277,151,68,70,0,0,48.7,19.3,1,
2017,Detroit Lions,Away,Minnesota Vikings,14,7,251,154,97,284,197,87,68,70,0,0,48.7,19.3,0,
2017,Detroit Lions,Home,Carolina Panthers,24,27,242,192,50,362,334,28,68,70,0,0,48.7,19.3,1,
2017,Detroit Lions,Away,New Orleans Saints,38,52,347,281,66,379,186,193,84,80,2,0,48.7,35.3,1,
2017,Detroit Lions,Home,Pittsburgh Steelers,15,20,482,411,71,392,317,75,68,70,0,0,48.7,19.3,1,
2017,Detroit Lions,Away,Green Bay Packers,30,17,417,353,64,311,233,78,35,58,3,0,48.7,13.7,1,
2017,Detroit Lions,Home,Cleveland Browns,38,24,345,241,104,413,212,201,68,70,0,0,48.7,19.3,1,
2017,Detroit Lions,Away,Chicago Bears,27,24,352,287,65,398,176,222,33,60,16,0,48.7,15.7,1,
2017,Detroit Lions,Home,Minnesota Vikings,23,30,289,236,53,408,272,136,68,70,0,0,48.7,19.3,1,
2017,Detroit Lions,Away,Baltimore Ravens,20,44,372,294,78,370,269,101,53,70,4,0,48.7,4.3,1,
2017,Detroit Lions,Away,Tampa Bay Buccaneers,24,21,434,381,53,400,267,133,55,44,9,0,48.7,6.3,1,
2017,Detroit Lions,Home,Chicago Bears,20,10,293,202,91,349,306,43,68,70,0,0,48.7,19.3,1,
2017,Detroit Lions,Away,Cincinnati Bengals,17,26,276,189,87,364,222,142,35,76,2,0,48.7,13.7,1,
2017,Detroit Lions,Home,Green Bay Packers,35,11,356,305,51,256,153,103,68,70,0,0,48.7,19.3,1,
2016,Detroit Lions,Home,Green Bay Packers,24,31,408,332,76,448,295,153,68,70,0,0,48.7,19.3,1,
2016,Detroit Lions,Away,Indianapolis Colts,39,35,448,332,116,450,368,82,76,46,5,0,48.7,27.3,1,
2016,Detroit Lions,Home,Tennessee Titans,15,16,375,238,137,363,224,139,68,70,0,0,48.7,19.3,1,
2016,Detroit Lions,Away,Green Bay Packers,27,34,418,368,50,324,201,123,72,84,17,0,48.7,23.3,1,
2016,Detroit Lions,Away,Chicago Bears,14,17,263,197,66,408,294,114,62,84,6,0,48.7,13.3,1,
2016,Detroit Lions,Home,Philadelphia Eagles,24,23,244,164,80,346,230,116,68,70,0,0,48.7,19.3,1,
2016,Detroit Lions,Home,Los Angeles Rams,31,28,348,265,83,387,311,76,68,70,0,0,48.7,19.3,1,
2016,Detroit Lions,Home,Washington Redskins,20,17,344,250,94,413,283,130,68,70,0,0,48.7,19.3,1,
2016,Detroit Lions,Away,Houston Texans,13,20,289,231,58,269,164,105,80,64,7,0,48.7,31.3,1,
2016,Detroit Lions,Away,Minnesota Vikings,22,16,311,214,97,337,259,78,68,70,0,0,48.7,19.3,0,
2016,Detroit Lions,Home,Jacksonville Jaguars,26,19,277,263,14,285,202,83,68,70,0,0,48.7,19.3,1,
2016,Detroit Lions,Home,Minnesota Vikings,16,13,308,214,94,306,224,82,68,70,0,0,48.7,19.3,1,
2016,Detroit Lions,Away,New Orleans Saints,28,13,422,337,85,369,319,50,68,93,5,0,48.7,19.3,1,
2016,Detroit Lions,Home,Chicago Bears,20,17,323,209,114,296,204,92,68,70,0,0,48.7,19.3,1,
2016,Detroit Lions,Away,New York Giants,6,17,324,268,56,300,186,114,55,100,5,1,48.7,6.3,1,
2015,Detroit Lions,Away,Chicago Bears,24,20,349,282,67,345,234,111,31,67,15,0,48.7,17.7,1,
2015,Detroit Lions,Away,San Diego Chargers,28,33,302,233,69,483,387,96,84,47,10,0,48.7,35.3,1,
2015,Detroit Lions,Away,Minnesota Vikings,16,26,323,285,38,350,151,199,67,50,0,0,48.7,18.3,1,
2015,Detroit Lions,Home,Denver Broncos,12,24,290,262,28,354,313,41,68,70,0,0,48.7,19.3,1,
2015,Detroit Lions,Away,Seattle Seahawks,10,13,256,203,53,345,235,110,74,41,8,0,48.7,25.3,1,
2015,Detroit Lions,Home,Arizona Cardinals,17,42,435,379,56,345,158,187,68,70,0,0,48.7,19.3,1,
2015,Detroit Lions,Home,Chicago Bears,37,34,546,391,155,444,353,91,68,70,0,0,48.7,19.3,1,
2015,Detroit Lions,Home,Minnesota Vikings,19,28,274,197,77,425,285,140,68,70,0,0,48.7,19.3,1,
2015,Detroit Lions,Away,Kansas City Chiefs,10,45,276,195,81,340,134,206,50,91,2,0,48.7,1.3,1,
2015,Detroit Lions,Away,Green Bay Packers,18,16,287,242,45,372,325,47,59,55,7,0,48.7,10.3,1,
2015,Detroit Lions,Home,Oakland Raiders,18,13,375,266,109,216,164,52,68,70,0,0,48.7,19.3,1,
2015,Detroit Lions,Home,Philadelphia Eagles,45,14,430,322,108,227,159,68,68,70,0,0,48.7,19.3,1,
2015,Detroit Lions,Home,Green Bay Packers,23,27,306,205,101,313,246,67,68,70,0,0,48.7,19.3,1,
2015,Detroit Lions,Away,New Orleans Saints,35,27,396,246,150,399,330,69,69,95,5,1,48.7,20.3,1,
2015,Detroit Lions,Home,San Francisco 49ers,32,17,371,284,87,322,201,121,68,70,0,0,48.7,19.3,1,
2018,Green Bay Packers,Home,Chicago Bears,24,23,370,301,69,294,155,139,62,65,10,0,44.15,17.85,1,
2018,Green Bay Packers,Home,Minnesota Vikings,29,29,351,253,98,480,412,68,80,71,5,0,44.15,35.85,1,
2018,Green Bay Packers,Away,Washington Redskins,17,31,340,240,100,386,220,166,62,96,6,1,44.15,17.85,1,
2018,Green Bay Packers,Home,Buffalo Bills,22,0,423,282,141,145,87,58,49,79,9,0,44.15,4.85,1,
2018,Green Bay Packers,Away,Detroit Lions,23,31,521,423,98,264,170,94,68,70,0,0,44.15,23.85,1,
2018,Green Bay Packers,Home,San Francisco 49ers,33,30,521,405,116,401,227,174,37,55,5,0,44.15,7.15,1,
2018,Green Bay Packers,Away,Los Angeles Rams,27,29,359,253,106,416,281,135,82,39,1,0,44.15,37.85,1,
2018,Green Bay Packers,Away,New England Patriots,17,31,367,250,117,433,310,123,40,76,2,0,44.15,4.15,1,
2018,Green Bay Packers,Home,Miami Dolphins,31,12,377,182,195,294,163,131,33,66,6,0,44.15,11.15,1,
2018,Green Bay Packers,Away,Seattle Seahawks,24,27,359,311,48,378,205,173,54,69,6,0,44.15,9.85,1,
2018,Green Bay Packers,Away,Minnesota Vikings,17,24,254,172,82,416,325,91,68,70,0,0,44.15,23.85,0,
2018,Green Bay Packers,Home,Arizona Cardinals,17,20,325,227,98,315,133,182,34,92,20,0,44.15,10.15,1,
2018,Green Bay Packers,Home,Atlanta Falcons,34,20,300,162,138,344,237,107,25,70,10,0,44.15,19.15,1,
2018,Green Bay Packers,Away,Chicago Bears,17,24,323,235,88,332,232,100,45,63,10,0,44.15,0.85,1,
2018,Green Bay Packers,Away,New York Jets,44,38,540,413,127,370,323,47,43,48,8,0,44.15,1.15,1,
2018,Green Bay Packers,Home,Detroit Lions,0,31,175,129,46,402,272,130,26,70,15,0,44.15,18.15,1,
2017,Green Bay Packers,Home,Seattle Seahawks,17,9,370,286,84,225,135,90,71,49,11,0,44.15,26.85,1,
2017,Green Bay Packers,Away,Atlanta Falcons,23,34,367,308,59,364,223,141,78,72,4,0,44.15,33.85,1,
2017,Green Bay Packers,Home,Cincinnati Bengals,27,24,344,280,64,301,191,110,89,44,4,0,44.15,44.85,1,
2017,Green Bay Packers,Home,Chicago Bears,35,14,260,169,91,308,205,103,65,62,5,0,44.15,20.85,1,
2017,Green Bay Packers,Away,Minnesota Vikings,10,23,227,155,72,351,239,112,68,70,0,0,44.15,23.85,0,
2017,Green Bay Packers,Home,New Orleans Saints,17,26,260,79,181,485,324,161,52,100,10,1,44.15,7.85,1,
2017,Green Bay Packers,Home,Detroit Lions,17,30,311,233,78,417,353,64,35,58,3,0,44.15,9.15,1,
2017,Green Bay Packers,Away,Chicago Bears,23,16,342,182,160,323,268,55,39,89,6,1,44.15,5.15,1,
2017,Green Bay Packers,Home,Baltimore Ravens,0,23,265,190,75,219,161,58,28,63,14,0,44.15,16.15,1,
2017,Green Bay Packers,Away,Pittsburgh Steelers,28,31,307,227,80,462,341,121,38,47,7,0,44.15,6.15,1,
2017,Green Bay Packers,Home,Tampa Bay Buccaneers,26,20,276,77,199,395,230,165,42,67,8,0,44.15,2.15,1,
2017,Green Bay Packers,Away,Cleveland Browns,27,21,341,256,85,345,209,136,29,58,24,0,44.15,15.15,1,
2017,Green Bay Packers,Away,Carolina Panthers,24,31,384,264,120,387,236,151,51,55,5,0,44.15,6.85,1,
2017,Green Bay Packers,Home,Minnesota Vikings,0,16,239,126,113,236,124,112,10,67,6,0,44.15,34.15,1,
2017,Green Bay Packers,Away,Detroit Lions,11,35,256,153,103,356,305,51,68,70,0,0,44.15,23.85,1,
2016,Green Bay Packers,Away,Detroit Lions,31,24,448,295,153,408,332,76,68,70,0,0,44.15,23.85,1,
2016,Green Bay Packers,Away,Minnesota Vikings,14,17,263,180,83,284,254,30,68,70,0,0,44.15,23.85,0,
2016,Green Bay Packers,Home,Detroit Lions,34,27,324,201,123,418,368,50,72,84,17,0,44.15,27.85,1,
2016,Green Bay Packers,Home,New York Giants,23,16,406,259,147,221,178,43,49,50,7,0,44.15,4.85,1,
2016,Green Bay Packers,Home,Dallas Cowboys,16,30,372,294,78,424,233,191,69,63,8,0,44.15,24.85,1,
2016,Green Bay Packers,Home,Chicago Bears,26,10,406,303,103,189,120,69,47,63,10,0,44.15,2.85,1,
2016,Green Bay Packers,Home,Indianapolis Colts,26,31,405,289,116,355,270,85,68,55,7,0,44.15,23.85,1,
2016,Green Bay Packers,Away,Tennessee Titans,25,47,402,333,69,446,292,154,56,49,3,0,44.15,11.85,1,
2016,Green Bay Packers,Away,Washington Redskins,24,42,424,340,84,515,364,151,38,44,23,0,44.15,6.15,1,
2016,Green Bay Packers,Away,Philadelphia Eagles,27,13,387,313,74,292,211,81,47,65,7,0,44.15,2.85,1,
2016,Green Bay Packers,Home,Houston Texans,21,13,309,200,109,307,184,123,32,90,8,0,44.15,12.15,1,
2016,Green Bay Packers,Home,Seattle Seahawks,38,10,330,237,93,354,218,136,26,85,5,0,44.15,18.15,1,
2016,Green Bay Packers,Away,Chicago Bears,30,27,451,225,226,449,354,95,11,57,12,0,44.15,33.15,1,
2016,Green Bay Packers,Home,Minnesota Vikings,38,25,348,308,40,446,353,93,37,78,8,0,44.15,7.15,1,
2015,Green Bay Packers,Home,Minnesota Vikings,13,20,350,274,76,242,91,151,24,70,11,0,44.15,20.15,1,
2015,Green Bay Packers,Away,Chicago Bears,31,23,322,189,133,402,213,189,68,39,11,0,44.15,23.85,1,
2015,Green Bay Packers,Home,Seattle Seahawks,27,17,361,234,127,324,205,119,62,52,9,0,44.15,17.85,1,
2015,Green Bay Packers,Home,Kansas City Chiefs,38,28,448,325,123,326,251,75,67,93,5,1,44.15,22.85,1,
2015,Green Bay Packers,Away,San Francisco 49ers,17,3,362,200,162,196,119,77,74,36,5,0,44.15,29.85,1,
2015,Green Bay Packers,Home,St. Louis Rams,24,10,322,236,86,334,143,191,67,51,15,0,44.15,22.85,1,
2015,Green Bay Packers,Home,San Diego Chargers,27,20,370,237,133,548,488,60,54,35,12,0,44.15,9.85,1,
2015,Green Bay Packers,Away,Denver Broncos,10,29,140,50,90,500,340,160,62,23,9,0,44.15,17.85,1,
2015,Green Bay Packers,Away,Carolina Panthers,29,37,402,331,71,427,297,130,57,50,10,0,44.15,12.85,1,
2015,Green Bay Packers,Home,Detroit Lions,16,18,372,325,47,287,242,45,59,55,7,0,44.15,14.85,1,
2015,Green Bay Packers,Away,Minnesota Vikings,30,13,320,196,124,342,248,94,30,50,8,0,44.15,14.15,1,
2015,Green Bay Packers,Home,Chicago Bears,13,17,365,188,177,290,189,101,39,92,19,1,44.15,5.15,1,
2015,Green Bay Packers,Away,Detroit Lions,27,23,313,246,67,306,205,101,68,70,0,0,44.15,23.85,1,
2015,Green Bay Packers,Home,Dallas Cowboys,28,7,435,205,230,270,99,171,53,100,10,1,44.15,8.85,1,
2015,Green Bay Packers,Away,Oakland Raiders,30,20,293,190,103,372,252,120,54,70,18,0,44.15,9.85,1,
2018,Houston Texans,Away,New England Patriots,20,27,325,158,167,389,267,122,62,61,10,0,69.05,7.05,1,
2018,Houston Texans,Away,Tennessee Titans,17,20,437,289,148,283,183,100,81,63,12,0,69.05,11.95,1,
2018,Houston Texans,Home,New York Giants,22,27,427,368,59,379,265,114,78,72,2,0,69.05,8.95,1,
2018,Houston Texans,Away,Indianapolis Colts,37,34,466,347,119,478,437,41,73,65,6,0,69.05,3.95,1,
2018,Houston Texans,Home,Dallas Cowboys,19,16,462,374,88,292,194,98,83,70,7,0,69.05,13.95,1,
2018,Houston Texans,Home,Buffalo Bills,20,13,216,142,74,229,129,100,87,60,9,0,69.05,17.95,1,
2018,Houston Texans,Away,Jacksonville Jaguars,20,7,272,131,141,259,189,70,68,54,15,0,69.05,1.05,1,
2018,Houston Texans,Home,Miami Dolphins,42,23,427,239,188,370,254,116,66,70,6,0,69.05,3.05,1,
2018,Houston Texans,Away,Denver Broncos,19,17,290,192,98,348,273,75,53,34,3,0,69.05,16.05,1,
2018,Houston Texans,Away,Washington Redskins,23,21,320,181,139,278,154,124,48,56,6,0,69.05,21.05,1,
2018,Houston Texans,Home,Tennessee Titans,34,17,462,181,281,365,260,105,51,35,7,0,69.05,18.05,1,
2018,Houston Texans,Home,Cleveland Browns,29,13,384,197,187,428,397,31,72,28,7,0,69.05,2.95,1,
2018,Houston Texans,Home,Indianapolis Colts,21,24,315,226,89,436,386,50,46,76,9,0,69.05,23.05,1,
2018,Houston Texans,Away,New York Jets,29,22,286,239,47,318,228,90,51,85,8,0,69.05,18.05,1,
2018,Houston Texans,Away,Philadelphia Eagles,30,32,371,309,62,519,462,57,44,44,5,0,69.05,25.05,1,
2018,Houston Texans,Home,Jacksonville Jaguars,20,3,342,208,134,119,89,30,46,93,6,1,69.05,23.05,1,
2017,Houston Texans,Home,Jacksonville Jaguars,7,29,203,110,93,280,125,155,80,49,10,0,69.05,10.95,1,
2017,Houston Texans,Away,Cincinnati Bengals,13,9,266,98,168,295,213,82,69,78,2,0,69.05,0.05,1,
2017,Houston Texans,Away,New England Patriots,33,36,417,292,125,396,337,59,84,53,4,0,69.05,14.95,1,
2017,Houston Texans,Home,Tennessee Titans,57,14,445,272,173,195,109,86,87,57,3,0,69.05,17.95,1,
2017,Houston Texans,Home,Kansas City Chiefs,34,42,392,248,144,450,323,127,89,59,9,0,69.05,19.95,1,
2017,Houston Texans,Home,Cleveland Browns,33,17,340,217,123,247,113,134,85,62,7,0,69.05,15.95,1,
2017,Houston Texans,Away,Seattle Seahawks,38,41,509,367,142,479,446,33,50,90,2,0,69.05,19.05,1,
2017,Houston Texans,Home,Indianapolis Colts,14,20,288,194,94,371,279,92,84,62,10,0,69.05,14.95,1,
2017,Houston Texans,Away,Los Angeles Rams,7,33,283,194,89,443,339,104,68,63,0,0,69.05,1.05,1,
2017,Houston Texans,Home,Arizona Cardinals,31,21,357,223,134,292,244,48,60,31,13,0,69.05,9.05,1,
2017,Houston Texans,Away,Baltimore Ravens,16,23,303,237,66,294,155,139,50,60,1,0,69.05,19.05,1,
2017,Houston Texans,Away,Tennessee Titans,13,24,384,331,53,344,146,198,60,39,4,0,69.05,9.05,1,
2017,Houston Texans,Away,Jacksonville Jaguars,7,45,186,99,87,464,326,138,72,55,5,0,69.05,2.95,1,
2017,Houston Texans,Home,Pittsburgh Steelers,6,34,227,51,176,330,226,104,51,56,8,0,69.05,18.05,1,
2017,Houston Texans,Away,Indianapolis Colts,13,22,209,124,85,250,104,146,9,66,7,0,69.05,60.05,1,
2016,Houston Texans,Away,Tennessee Titans,17,24,289,243,46,236,133,103,52,97,7,0,69.05,17.05,1,
2016,Houston Texans,Home,Chicago Bears,23,14,344,215,129,258,185,73,84,61,3,0,69.05,14.95,1,
2016,Houston Texans,Home,Kansas City Chiefs,19,12,351,254,97,291,172,119,91,63,6,0,69.05,21.95,1,
2016,Houston Texans,Away,New England Patriots,0,27,284,175,109,282,97,185,68,60,4,0,69.05,1.05,1,
2016,Houston Texans,Home,Tennessee Titans,27,20,359,244,115,320,196,124,82,48,9,0,69.05,12.95,1,
2016,Houston Texans,Away,Minnesota Vikings,13,31,214,155,59,351,255,96,68,70,0,0,69.05,1.05,0,
2016,Houston Texans,Home,Indianapolis Colts,26,23,414,256,158,392,231,161,84,68,11,0,69.05,14.95,1,
2016,Houston Texans,Away,Denver Broncos,9,27,271,131,140,347,157,190,71,17,5,0,69.05,1.95,1,
2016,Houston Texans,Home,Detroit Lions,20,13,269,164,105,289,231,58,80,64,7,0,69.05,10.95,1,
2016,Houston Texans,Away,Jacksonville Jaguars,24,21,273,92,181,327,247,80,69,50,10,0,69.05,0.05,1,
2016,Houston Texans,Away,Oakland Raiders,20,27,354,230,124,325,295,30,63,39,6,0,69.05,6.05,1,
2016,Houston Texans,Home,San Diego Chargers,13,21,353,239,114,302,235,67,71,58,14,0,69.05,1.95,1,
2016,Houston Texans,Away,Green Bay Packers,13,21,307,184,123,309,200,109,32,90,8,0,69.05,37.05,1,
2016,Houston Texans,Away,Indianapolis Colts,22,17,316,131,185,348,265,83,34,63,12,0,69.05,35.05,1,
2016,Houston Texans,Home,Jacksonville Jaguars,21,20,387,308,79,150,83,67,37,48,19,0,69.05,32.05,1,
2016,Houston Texans,Home,Cincinnati Bengals,12,10,250,155,95,294,244,50,71,86,10,0,69.05,1.95,1,
2015,Houston Texans,Home,Jacksonville Jaguars,30,6,402,242,160,215,183,32,55,49,6,0,69.05,14.05,1,
2015,Houston Texans,Home,Kansas City Chiefs,20,27,396,298,98,330,233,97,80,38,10,0,69.05,10.95,1,
2015,Houston Texans,Away,Carolina Panthers,17,24,300,239,61,350,178,172,88,43,6,0,69.05,18.95,1,
2015,Houston Texans,Home,Tampa Bay Buccaneers,19,9,413,227,186,318,261,57,78,74,4,1,69.05,8.95,1,
2015,Houston Texans,Home,Indianapolis Colts,20,27,444,362,82,323,213,110,83,54,4,0,69.05,13.95,1,
2015,Houston Texans,Away,Jacksonville Jaguars,31,20,382,287,95,394,311,83,73,55,18,0,69.05,3.95,1,
2015,Houston Texans,Away,Miami Dolphins,26,44,322,251,71,503,255,248,84,62,13,0,69.05,14.95,1,
2015,Houston Texans,Home,Tennessee Titans,20,6,270,214,56,211,125,86,70,86,0,1,69.05,0.95,1,
2015,Houston Texans,Away,Cincinnati Bengals,10,6,256,174,82,256,182,74,53,60,4,1,69.05,16.05,1,
2015,Houston Texans,Home,New York Jets,24,17,364,241,123,267,197,70,52,39,11,0,69.05,17.05,1,
2015,Houston Texans,Home,New Orleans Saints,24,6,362,195,167,268,218,50,54,90,9,0,69.05,15.05,1,
2015,Houston Texans,Away,Buffalo Bills,21,30,401,275,126,390,203,187,47,65,8,0,69.05,22.05,1,
2015,Houston Texans,Home,New England Patriots,6,27,189,102,87,313,197,116,54,90,5,0,69.05,15.05,1,
2015,Houston Texans,Away,Indianapolis Colts,16,10,305,150,155,190,140,50,45,53,15,0,69.05,24.05,1,
2015,Houston Texans,Away,Tennessee Titans,34,6,330,202,128,257,227,30,73,75,16,0,69.05,3.95,1,
2018,Indianapolis Colts,Home,Cincinnati Bengals,23,34,380,305,75,330,229,101,59,91,11,0,53.1,5.9,1,
2018,Indianapolis Colts,Away,Washington Redskins,21,9,281,177,104,334,269,65,71,88,5,0,53.1,17.9,1,
2018,Indianapolis Colts,Away,Philadelphia Eagles,16,20,209,141,68,379,227,152,61,92,5,1,53.1,7.9,1,
2018,Indianapolis Colts,Home,Houston Texans,34,37,478,437,41,466,347,119,73,65,6,0,53.1,19.9,1,
2018,Indianapolis Colts,Away,New England Patriots,24,38,439,355,84,438,341,97,66,96,6,0,53.1,12.9,1,
2018,Indianapolis Colts,Away,New York Jets,34,42,428,301,127,374,267,107,60,53,7,0,53.1,6.9,1,
2018,Indianapolis Colts,Home,Buffalo Bills,37,5,376,156,220,303,168,135,44,56,3,0,53.1,9.1,1,
2018,Indianapolis Colts,Away,Oakland Raiders,42,28,461,239,222,347,244,103,69,67,8,0,53.1,15.9,1,
2018,Indianapolis Colts,Home,Jacksonville Jaguars,29,26,366,285,81,415,324,91,38,46,10,0,53.1,15.1,1,
2018,Indianapolis Colts,Home,Tennessee Titans,38,10,397,295,102,267,176,91,42,81,7,0,53.1,11.1,1,
2018,Indianapolis Colts,Home,Miami Dolphins,27,24,455,337,118,314,201,113,57,74,11,0,53.1,3.9,1,
2018,Indianapolis Colts,Away,Jacksonville Jaguars,0,6,265,224,41,211,132,79,78,50,13,0,53.1,24.9,1,
2018,Indianapolis Colts,Away,Houston Texans,24,21,436,386,50,315,226,89,46,76,9,0,53.1,7.1,1,
2018,Indianapolis Colts,Home,Dallas Cowboys,23,0,370,192,178,292,180,112,46,80,5,0,53.1,7.1,1,
2018,Indianapolis Colts,Home,New York Giants,28,27,402,353,49,392,309,83,33,85,7,0,53.1,20.1,1,
2018,Indianapolis Colts,Away,Tennessee Titans,33,17,436,278,158,258,165,93,53,67,4,0,53.1,0.1,1,
2017,Indianapolis Colts,Away,Los Angeles Rams,9,46,225,150,75,373,310,63,90,38,2,0,53.1,36.9,1,
2017,Indianapolis Colts,Home,Arizona Cardinals,13,16,266,190,76,389,306,83,78,66,6,0,53.1,24.9,1,
2017,Indianapolis Colts,Home,Cleveland Browns,31,28,335,243,92,346,235,111,83,45,5,0,53.1,29.9,1,
2017,Indianapolis Colts,Away,Seattle Seahawks,18,46,237,139,98,477,283,194,61,54,8,0,53.1,7.9,1,
2017,Indianapolis Colts,Home,San Francisco 49ers,26,23,447,288,159,402,336,66,68,60,12,0,53.1,14.9,1,
2017,Indianapolis Colts,Away,Tennessee Titans,22,36,297,212,85,473,305,168,57,55,7,0,53.1,3.9,1,
2017,Indianapolis Colts,Home,Jacksonville Jaguars,0,27,232,136,96,518,330,188,72,59,17,0,53.1,18.9,1,
2017,Indianapolis Colts,Away,Cincinnati Bengals,23,24,331,216,115,276,218,58,39,68,9,0,53.1,14.1,1,
2017,Indianapolis Colts,Away,Houston Texans,20,14,371,279,92,288,194,94,84,62,10,0,53.1,30.9,1,
2017,Indianapolis Colts,Home,Pittsburgh Steelers,17,20,267,196,71,316,228,88,42,70,5,0,53.1,11.1,1,
2017,Indianapolis Colts,Home,Tennessee Titans,16,20,254,165,89,276,184,92,47,51,10,0,53.1,6.1,1,
2017,Indianapolis Colts,Away,Jacksonville Jaguars,10,30,290,149,141,426,330,96,70,74,7,0,53.1,16.9,1,
2017,Indianapolis Colts,Away,Buffalo Bills,7,13,227,64,163,319,92,227,32,69,15,1,53.1,21.1,1,
2017,Indianapolis Colts,Home,Denver Broncos,13,25,228,158,70,462,251,211,25,62,5,0,53.1,28.1,1,
2017,Indianapolis Colts,Away,Baltimore Ravens,16,23,296,203,93,323,220,103,63,78,14,0,53.1,9.9,1,
2017,Indianapolis Colts,Home,Houston Texans,22,13,250,104,146,209,124,85,9,66,7,0,53.1,44.1,1,
2016,Indianapolis Colts,Home,Jacksonville Jaguars,24,20,384,290,94,470,288,182,39,66,6,0,53.1,14.1,1,
2016,Indianapolis Colts,Home,Detroit Lions,35,39,450,368,82,448,332,116,76,46,5,0,53.1,22.9,1,
2016,Indianapolis Colts,Away,Denver Broncos,20,34,253,170,83,400,266,134,85,15,4,0,53.1,31.9,1,
2016,Indianapolis Colts,Home,San Diego Chargers,26,22,410,317,93,352,315,37,85,52,8,0,53.1,31.9,1,
2016,Indianapolis Colts,Away,Jacksonville Jaguars,27,30,284,190,94,331,195,136,59,59,7,0,53.1,5.9,1,
2016,Indianapolis Colts,Home,Chicago Bears,29,23,396,298,98,522,397,125,60,59,5,0,53.1,6.9,1,
2016,Indianapolis Colts,Away,Houston Texans,23,26,392,231,161,414,256,158,84,68,11,0,53.1,30.9,1,
2016,Indianapolis Colts,Away,Tennessee Titans,34,26,422,341,81,331,207,124,68,50,5,0,53.1,14.9,1,
2016,Indianapolis Colts,Home,Kansas City Chiefs,14,30,277,172,105,422,334,88,68,69,9,0,53.1,14.9,1,
2016,Indianapolis Colts,Away,Green Bay Packers,31,26,355,270,85,405,289,116,68,55,7,0,53.1,14.9,1,
2016,Indianapolis Colts,Home,Tennessee Titans,24,17,327,251,76,351,254,97,34,61,10,0,53.1,19.1,1,
2016,Indianapolis Colts,Home,Pittsburgh Steelers,7,28,310,219,91,369,221,148,39,85,9,0,53.1,14.1,1,
2016,Indianapolis Colts,Away,New York Jets,41,10,421,282,139,250,214,36,45,60,6,0,53.1,8.1,1,
2016,Indianapolis Colts,Home,Houston Texans,17,22,348,265,83,316,131,185,34,63,12,0,53.1,19.1,1,
2016,Indianapolis Colts,Away,Minnesota Vikings,34,6,411,250,161,282,248,34,68,70,0,0,53.1,14.9,0,
2016,Indianapolis Colts,Away,Oakland Raiders,25,33,390,288,102,463,253,210,50,61,9,0,53.1,3.1,1,
2015,Indianapolis Colts,Home,Tennessee Titans,30,24,327,200,127,231,94,137,30,79,9,0,53.1,23.1,1,
2015,Indianapolis Colts,Away,Buffalo Bills,14,27,304,240,64,342,195,147,56,78,15,0,53.1,2.9,1,
2015,Indianapolis Colts,Home,New York Jets,7,20,343,250,93,344,243,101,69,41,7,0,53.1,15.9,1,
2015,Indianapolis Colts,Away,Tennessee Titans,35,33,378,245,133,433,345,88,74,77,3,0,53.1,20.9,1,
2015,Indianapolis Colts,Home,Jacksonville Jaguars,16,13,326,266,60,431,289,142,62,72,9,0,53.1,8.9,1,
2015,Indianapolis Colts,Away,Houston Texans,27,20,323,213,110,444,362,82,83,54,4,0,53.1,29.9,1,
2015,Indianapolis Colts,Home,New England Patriots,27,34,409,289,120,417,301,116,52,30,4,0,53.1,1.1,1,
2015,Indianapolis Colts,Home,New Orleans Saints,21,27,376,301,75,449,266,183,55,56,12,0,53.1,1.9,1,
2015,Indianapolis Colts,Away,Carolina Panthers,26,29,359,223,136,379,239,140,60,100,7,1,53.1,6.9,1,
2015,Indianapolis Colts,Home,Denver Broncos,27,24,365,245,120,309,274,35,54,32,5,0,53.1,0.9,1,
2015,Indianapolis Colts,Home,Tampa Bay Buccaneers,25,12,336,309,27,344,212,132,37,69,10,0,53.1,16.1,1,
2015,Indianapolis Colts,Away,Pittsburgh Steelers,10,45,240,186,54,522,364,158,37,74,2,0,53.1,16.1,1,
2015,Indianapolis Colts,Away,Jacksonville Jaguars,16,51,322,227,95,380,226,154,79,66,5,0,53.1,25.9,1,
2015,Indianapolis Colts,Home,Houston Texans,10,16,190,140,50,305,150,155,45,53,15,0,53.1,8.1,1,
2015,Indianapolis Colts,Away,Miami Dolphins,18,12,268,168,100,361,279,82,82,69,15,0,53.1,28.9,1,
2018,Jacksonville Jaguars,Away,New York Giants,20,15,305,168,137,324,210,114,59,85,7,1,67.9,8.9,1,
2018,Jacksonville Jaguars,Home,New England Patriots,31,20,480,376,104,302,220,82,97,46,20,1,67.9,29.1,1,
2018,Jacksonville Jaguars,Home,Tennessee Titans,6,9,232,145,87,233,83,150,89,61,10,0,67.9,21.1,1,
2018,Jacksonville Jaguars,Home,New York Jets,31,12,503,377,126,178,144,34,86,70,10,0,67.9,18.1,1,
2018,Jacksonville Jaguars,Away,Kansas City Chiefs,14,30,502,401,101,424,298,126,58,90,5,0,67.9,9.9,1,
2018,Jacksonville Jaguars,Home,Houston Texans,7,20,259,189,70,272,131,141,68,54,15,0,67.9,0.1,1,
2018,Jacksonville Jaguars,Home,Philadelphia Eagles,18,24,335,265,70,395,262,133,48,59,12,0,67.9,19.9,1,
2018,Jacksonville Jaguars,Away,Indianapolis Colts,26,29,415,324,91,366,285,81,38,46,10,0,67.9,29.9,1,
2018,Jacksonville Jaguars,Home,Pittsburgh Steelers,16,20,243,64,179,323,297,26,73,60,8,0,67.9,5.1,1,
2018,Jacksonville Jaguars,Away,Buffalo Bills,21,24,333,107,226,327,160,167,44,79,12,0,67.9,23.9,1,
2018,Jacksonville Jaguars,Home,Indianapolis Colts,6,0,211,132,79,265,224,41,78,50,13,0,67.9,10.1,1,
2018,Jacksonville Jaguars,Away,Tennessee Titans,9,30,255,195,60,426,162,264,44,43,5,0,67.9,23.9,1,
2018,Jacksonville Jaguars,Home,Washington Redskins,13,16,192,20,172,245,136,109,64,58,12,0,67.9,3.9,1,
2018,Jacksonville Jaguars,Away,Miami Dolphins,17,7,244,118,126,183,121,62,73,49,9,0,67.9,5.1,1,
2018,Jacksonville Jaguars,Away,Houston Texans,3,20,119,89,30,342,208,134,46,93,6,1,67.9,21.9,1,
2017,Jacksonville Jaguars,Away,Houston Texans,29,7,280,125,155,203,110,93,80,49,10,0,67.9,12.1,1,
2017,Jacksonville Jaguars,Home,Tennessee Titans,16,37,310,211,99,390,211,179,84,59,10,0,67.9,16.1,1,
2017,Jacksonville Jaguars,Home,Baltimore Ravens,44,7,410,244,166,186,52,134,70,51,10,0,67.9,2.1,1,
2017,Jacksonville Jaguars,Away,New York Jets,20,23,311,136,175,471,215,256,64,44,5,0,67.9,3.9,1,
2017,Jacksonville Jaguars,Away,Pittsburgh Steelers,30,9,313,82,231,371,301,70,73,80,9,0,67.9,5.1,1,
2017,Jacksonville Jaguars,Home,Los Angeles Rams,17,27,389,220,169,249,107,142,88,68,10,1,67.9,20.1,1,
2017,Jacksonville Jaguars,Away,Indianapolis Colts,27,0,518,330,188,232,136,96,72,59,17,0,67.9,4.1,1,
2017,Jacksonville Jaguars,Home,Cincinnati Bengals,23,7,408,259,149,148,119,29,78,74,12,0,67.9,10.1,1,
2017,Jacksonville Jaguars,Home,Los Angeles Chargers,20,17,398,263,135,322,235,87,76,75,5,0,67.9,8.1,1,
2017,Jacksonville Jaguars,Away,Cleveland Browns,19,7,284,145,139,184,134,50,38,68,16,0,67.9,29.9,1,
2017,Jacksonville Jaguars,Home,Indianapolis Colts,30,10,426,330,96,290,149,141,70,74,7,0,67.9,2.1,1,
2017,Jacksonville Jaguars,Home,Seattle Seahawks,30,24,424,268,156,401,260,141,54,50,5,0,67.9,13.9,1,
2017,Jacksonville Jaguars,Home,Houston Texans,45,7,464,326,138,186,99,87,72,55,5,0,67.9,4.1,1,
2017,Jacksonville Jaguars,Away,San Francisco 49ers,33,44,472,380,92,369,238,131,52,64,1,0,67.9,15.9,1,
2017,Jacksonville Jaguars,Away,Tennessee Titans,10,15,229,146,83,232,116,116,23,45,5,0,67.9,44.9,1,
2016,Jacksonville Jaguars,Away,Indianapolis Colts,20,24,470,288,182,384,290,94,39,66,6,0,67.9,28.9,1,
2016,Jacksonville Jaguars,Away,San Diego Chargers,14,38,388,319,69,357,207,150,82,51,7,0,67.9,14.1,1,
2016,Jacksonville Jaguars,Home,Baltimore Ravens,17,19,216,168,48,283,199,84,88,50,8,0,67.9,20.1,1,
2016,Jacksonville Jaguars,Home,Indianapolis Colts,30,27,331,195,136,284,190,94,59,59,7,0,67.9,8.9,1,
2016,Jacksonville Jaguars,Away,Chicago Bears,17,16,317,263,54,389,297,92,69,93,7,0,67.9,1.1,1,
2016,Jacksonville Jaguars,Home,Oakland Raiders,16,33,344,239,105,344,200,144,70,47,6,0,67.9,2.1,1,
2016,Jacksonville Jaguars,Away,Tennessee Titans,22,36,370,322,48,494,280,214,71,78,3,0,67.9,3.1,1,
2016,Jacksonville Jaguars,Away,Kansas City Chiefs,14,19,449,244,205,231,169,62,62,51,7,0,67.9,5.9,1,
2016,Jacksonville Jaguars,Home,Houston Texans,21,24,327,247,80,273,92,181,69,50,10,0,67.9,1.1,1,
2016,Jacksonville Jaguars,Away,Detroit Lions,19,26,285,202,83,277,263,14,68,70,0,0,67.9,0.1,1,
2016,Jacksonville Jaguars,Away,Buffalo Bills,21,28,301,118,183,304,151,153,42,65,13,0,67.9,25.9,1,
2016,Jacksonville Jaguars,Home,Denver Broncos,10,20,333,179,154,206,102,104,70,70,10,0,67.9,2.1,1,
2016,Jacksonville Jaguars,Home,Minnesota Vikings,16,25,315,230,85,377,292,85,71,70,5,0,67.9,3.1,1,
2016,Jacksonville Jaguars,Away,Houston Texans,20,21,150,83,67,387,308,79,37,48,19,0,67.9,30.9,1,
2016,Jacksonville Jaguars,Home,Tennessee Titans,38,17,415,331,84,263,205,58,67,84,5,0,67.9,0.9,1,
2015,Jacksonville Jaguars,Away,Houston Texans,6,30,215,183,32,402,242,160,55,49,6,0,67.9,12.9,1,
2015,Jacksonville Jaguars,Home,Carolina Panthers,9,20,265,169,96,263,158,105,77,55,7,0,67.9,9.1,1,
2015,Jacksonville Jaguars,Home,Miami Dolphins,23,20,396,273,123,386,344,42,87,57,5,0,67.9,19.1,1,
2015,Jacksonville Jaguars,Away,New England Patriots,17,51,293,236,57,471,346,125,68,41,6,0,67.9,0.1,1,
2015,Jacksonville Jaguars,Away,Indianapolis Colts,13,16,431,289,142,326,266,60,62,72,9,0,67.9,5.9,1,
2015,Jacksonville Jaguars,Away,Tampa Bay Buccaneers,31,38,325,270,55,369,186,183,84,55,9,0,67.9,16.1,1,
2015,Jacksonville Jaguars,Home,Houston Texans,20,31,394,311,83,382,287,95,73,55,18,0,67.9,5.1,1,
2015,Jacksonville Jaguars,Home,Buffalo Bills,34,31,295,175,120,375,260,115,48,74,2,0,67.9,19.9,1,
2015,Jacksonville Jaguars,Away,New York Jets,23,28,436,338,98,290,261,29,56,36,10,0,67.9,11.9,1,
2015,Jacksonville Jaguars,Away,Baltimore Ravens,22,20,258,168,90,397,308,89,60,34,10,0,67.9,7.9,1,
2015,Jacksonville Jaguars,Home,Tennessee Titans,19,13,308,218,90,316,212,104,75,90,5,0,67.9,7.1,1,
2015,Jacksonville Jaguars,Home,San Diego Chargers,25,31,420,318,102,369,290,79,75,60,8,0,67.9,7.1,1,
2015,Jacksonville Jaguars,Away,Tennessee Titans,39,42,383,302,81,467,257,210,56,60,1,0,67.9,11.9,1,
2015,Jacksonville Jaguars,Home,Indianapolis Colts,51,16,380,226,154,322,227,95,79,66,5,0,67.9,11.1,1,
2015,Jacksonville Jaguars,Home,Atlanta Falcons,17,23,370,285,85,328,245,83,65,60,8,0,67.9,2.9,1,
2015,Jacksonville Jaguars,Away,New Orleans Saints,27,38,412,347,65,537,402,135,78,75,19,0,67.9,10.1,1,
2018,Kansas City Cheifs,Away,Los Angeles Chargers,38,28,362,256,106,541,418,123,84,52,8,0,53.4,30.6,1,
2018,Kansas City Cheifs,Away,Pittsburgh Steelers,42,37,449,322,127,475,442,33,80,65,10,0,53.4,26.6,1,
2018,Kansas City Cheifs,Home,San Francisco 49ers,38,27,384,307,77,406,228,178,70,64,4,0,53.4,16.6,1,
2018,Kansas City Cheifs,Away,Denver Broncos,27,23,446,304,142,385,226,159,65,51,5,0,53.4,11.6,1,
2018,Kansas City Cheifs,Home,Jacksonville Jaguars,30,14,424,298,126,502,401,101,58,90,5,0,53.4,4.6,1,
2018,Kansas City Cheifs,Away,New England Patriots,40,43,446,352,94,500,327,173,45,85,0,0,53.4,8.4,1,
2018,Kansas City Cheifs,Home,Cincinnati Bengals,45,10,551,353,198,239,174,65,59,42,10,0,53.4,5.6,1,
2018,Kansas City Cheifs,Home,Denver Broncos,30,23,340,291,49,411,222,189,56,45,12,0,53.4,2.6,1,
2018,Kansas City Cheifs,Away,Cleveland Browns,37,21,499,360,139,388,286,102,53,49,16,0,53.4,0.4,1,
2018,Kansas City Cheifs,Home,Arizona Cardinals,26,14,330,212,118,260,166,94,43,51,5,0,53.4,10.4,1,
2018,Kansas City Cheifs,Away,Los Angeles Rams,51,54,546,448,98,455,379,76,65,56,0,0,53.4,11.6,1,
2018,Kansas City Cheifs,Away,Oakland Raiders,40,33,469,295,174,442,271,171,57,52,6,0,53.4,3.6,1,
2018,Kansas City Cheifs,Home,Baltimore Ravens,27,24,442,348,94,321,127,194,27,72,0,0,53.4,26.4,1,
2018,Kansas City Cheifs,Home,Los Angeles Chargers,28,29,294,234,60,407,288,119,39,76,5,0,53.4,14.4,1,
2018,Kansas City Cheifs,Away,Seattle Seahawks,31,38,419,265,154,464,254,210,43,82,8,0,53.4,10.4,1,
2018,Kansas City Cheifs,Home,Oakland Raiders,35,3,409,310,99,292,165,127,45,43,15,0,53.4,8.4,1,
2017,Kansas City Cheifs,Home,Philadelphia Eagles,27,20,344,232,112,406,299,107,68,95,7,0,53.4,14.6,1,
2017,Kansas City Cheifs,Away,Los Angeles Chargers,24,10,311,122,189,330,226,104,84,25,5,0,53.4,30.6,1,
2017,Kansas City Cheifs,Home,Washington Redskins,29,20,429,261,168,331,220,111,82,55,14,0,53.4,28.6,1,
2017,Kansas City Cheifs,Away,Houston Texans,42,34,450,323,127,392,248,144,89,59,9,0,53.4,35.6,1,
2017,Kansas City Cheifs,Home,Pittsburgh Steelers,13,19,251,223,28,439,245,194,60,56,14,0,53.4,6.6,1,
2017,Kansas City Cheifs,Away,Oakland Raiders,30,31,425,331,94,505,417,88,62,78,1,0,53.4,8.6,1,
2017,Kansas City Cheifs,Home,Denver Broncos,29,19,276,197,79,364,187,177,44,41,12,0,53.4,9.4,1,
2017,Kansas City Cheifs,Away,New York Giants,9,12,363,229,134,317,205,112,50,44,23,0,53.4,3.4,1,
2017,Kansas City Cheifs,Home,Buffalo Bills,10,16,236,181,55,268,164,104,62,36,9,0,53.4,8.6,1,
2017,Kansas City Cheifs,Away,New York Jets,31,38,474,362,112,488,331,157,48,64,0,0,53.4,5.4,1,
2017,Kansas City Cheifs,Home,Oakland Raiders,26,15,408,243,165,268,198,70,68,70,0,0,53.4,14.6,1,
2017,Kansas City Cheifs,Home,Los Angeles Chargers,30,13,397,223,174,307,209,98,53,36,9,0,53.4,0.4,1,
2017,Kansas City Cheifs,Home,Miami Dolphins,29,13,404,301,103,345,286,59,23,71,15,0,53.4,30.4,1,
2017,Kansas City Cheifs,Away,Denver Broncos,27,24,379,269,110,336,226,110,17,76,4,0,53.4,36.4,1,
2016,Kansas City Cheifs,Away,San Diego Chargers,37,27,365,262,103,398,269,129,59,56,10,0,53.4,5.6,1,
2016,Kansas City Cheifs,Home,San Diego Chargers,33,27,413,330,83,388,233,155,84,51,9,0,53.4,30.6,1,
2016,Kansas City Cheifs,Away,Houston Texans,12,19,291,172,119,351,254,97,91,63,6,0,53.4,37.6,1,
2016,Kansas City Cheifs,Home,New York Jets,24,3,293,221,72,305,188,117,65,63,9,0,53.4,11.6,1,
2016,Kansas City Cheifs,Away,Pittsburgh Steelers,14,43,357,270,87,436,287,149,59,80,6,1,53.4,5.6,1,
2016,Kansas City Cheifs,Away,Oakland Raiders,26,10,406,223,183,285,221,64,61,100,6,1,53.4,7.6,1,
2016,Kansas City Cheifs,Home,New Orleans Saints,27,21,326,214,112,463,359,104,68,47,9,0,53.4,14.6,1,
2016,Kansas City Cheifs,Away,Indianapolis Colts,30,14,422,334,88,277,172,105,68,69,9,0,53.4,14.6,1,
2016,Kansas City Cheifs,Home,Jacksonville Jaguars,19,14,231,169,62,449,244,205,62,51,7,0,53.4,8.6,1,
2016,Kansas City Cheifs,Away,Carolina Panthers,20,17,256,165,91,341,242,99,45,76,6,0,53.4,8.4,1,
2016,Kansas City Cheifs,Home,Tampa Bay Buccaneers,17,19,343,261,82,442,326,116,46,42,9,0,53.4,7.4,1,
2016,Kansas City Cheifs,Away,Denver Broncos,30,27,273,190,83,464,340,124,44,25,15,0,53.4,9.4,1,
2016,Kansas City Cheifs,Home,Oakland Raiders,21,13,323,258,65,244,109,135,21,57,7,0,53.4,32.4,1,
2016,Kansas City Cheifs,Home,Tennessee Titans,17,19,316,159,157,389,241,148,1,65,5,0,53.4,52.4,1,
2016,Kansas City Cheifs,Home,Denver Broncos,33,10,484,246,238,246,183,63,53,80,9,1,53.4,0.4,1,
2015,Kansas City Cheifs,Home,Oakland Raiders,23,17,339,150,189,205,157,48,37,56,9,0,53.4,16.4,1,
2015,Kansas City Cheifs,Away,Houston Texans,27,20,330,233,97,396,298,98,80,38,10,0,53.4,26.6,1,
2015,Kansas City Cheifs,Home,Denver Broncos,24,31,314,167,147,299,238,61,87,59,13,0,53.4,33.6,1,
2015,Kansas City Cheifs,Away,Green Bay Packers,28,38,326,251,75,448,325,123,67,93,5,1,53.4,13.6,1,
2015,Kansas City Cheifs,Away,Cincinnati Bengals,21,36,461,348,113,445,321,124,68,64,5,0,53.4,14.6,1,
2015,Kansas City Cheifs,Home,Chicago Bears,17,18,287,170,117,328,241,87,72,51,10,0,53.4,18.6,1,
2015,Kansas City Cheifs,Away,Minnesota Vikings,10,16,328,271,57,321,237,84,54,50,10,0,53.4,0.6,1,
2015,Kansas City Cheifs,Home,Pittsburgh Steelers,23,13,377,239,138,339,192,147,58,57,7,0,53.4,4.6,1,
2015,Kansas City Cheifs,Home,Detroit Lions,45,10,340,134,206,276,195,81,50,91,2,0,53.4,3.4,1,
2015,Kansas City Cheifs,Away,Denver Broncos,29,13,303,197,106,221,152,69,64,10,5,0,53.4,10.6,1,
2015,Kansas City Cheifs,Away,San Diego Chargers,33,3,385,232,153,201,149,52,87,12,4,0,53.4,33.6,1,
2015,Kansas City Cheifs,Home,Buffalo Bills,30,22,413,255,158,415,286,129,35,99,7,1,53.4,18.4,1,
2015,Kansas City Cheifs,Away,Oakland Raiders,34,20,232,143,89,361,262,99,57,95,3,0,53.4,3.6,1,
2015,Kansas City Cheifs,Home,San Diego Chargers,10,3,329,179,150,280,236,44,61,97,14,1,53.4,7.6,1,
2015,Kansas City Cheifs,Away,Baltimore Ravens,34,14,277,164,113,366,273,93,41,35,5,0,53.4,12.4,1,
2015,Kansas City Cheifs,Home,Cleveland Browns,17,13,258,122,136,368,136,232,36,91,16,0,53.4,17.4,1,
2018,Los Angeles Chargers,Home,Kansas City Chiefs,28,38,541,418,123,362,256,106,84,52,8,0,63.8,20.2,1,
2018,Los Angeles Chargers,Away,Buffalo Bills,31,20,349,240,109,293,209,84,83,63,6,0,63.8,19.2,1,
2018,Los Angeles Chargers,Away,Los Angeles Rams,23,35,356,215,141,521,350,171,80,50,5,0,63.8,16.2,1,
2018,Los Angeles Chargers,Home,San Francisco 49ers,29,27,368,242,126,364,288,76,78,56,9,0,63.8,14.2,1,
2018,Los Angeles Chargers,Home,Oakland Raiders,26,10,412,333,79,289,248,41,75,60,10,0,63.8,11.2,1,
2018,Los Angeles Chargers,Away,Cleveland Browns,38,14,449,203,246,317,214,103,51,61,9,0,63.8,12.8,1,
2018,Los Angeles Chargers,Home,Tennessee Titans,20,19,344,297,47,390,226,164,66,75,6,0,63.8,2.2,1,
2018,Los Angeles Chargers,Away,Seattle Seahawks,25,17,375,215,160,356,202,154,56,78,4,0,63.8,7.8,1,
2018,Los Angeles Chargers,Away,Oakland Raiders,20,6,335,222,113,317,203,114,69,15,16,0,63.8,5.2,1,
2018,Los Angeles Chargers,Home,Denver Broncos,22,23,479,384,95,325,217,108,69,67,4,0,63.8,5.2,1,
2018,Los Angeles Chargers,Home,Arizona Cardinals,45,10,414,236,178,149,87,62,74,52,3,0,63.8,10.2,1,
2018,Los Angeles Chargers,Away,Pittsburgh Steelers,33,30,371,286,85,336,271,65,57,55,8,0,63.8,6.8,1,
2018,Los Angeles Chargers,Home,Cincinnati Bengals,26,21,288,203,85,295,151,144,71,42,2,0,63.8,7.2,1,
2018,Los Angeles Chargers,Away,Kansas City Chiefs,29,28,407,288,119,294,234,60,39,76,5,0,63.8,24.8,1,
2018,Los Angeles Chargers,Home,Baltimore Ravens,10,22,198,147,51,361,202,159,60,89,5,0,63.8,3.8,1,
2018,Los Angeles Chargers,Away,Denver Broncos,23,9,276,160,116,370,288,82,51,22,6,0,63.8,12.8,1,
2017,Los Angeles Chargers,Away,Denver Broncos,21,24,249,185,64,321,181,140,73,39,12,0,63.8,9.2,1,
2017,Los Angeles Chargers,Home,Miami Dolphins,17,19,367,323,44,336,225,111,71,68,7,0,63.8,7.2,1,
2017,Los Angeles Chargers,Home,Kansas City Chiefs,10,24,330,226,104,311,122,189,84,25,5,0,63.8,20.2,1,
2017,Los Angeles Chargers,Home,Philadelphia Eagles,24,26,400,342,58,454,240,214,72,70,6,0,63.8,8.2,1,
2017,Los Angeles Chargers,Away,New York Giants,27,22,382,258,124,335,183,152,76,90,7,0,63.8,12.2,1,
2017,Los Angeles Chargers,Away,Oakland Raiders,17,16,343,263,80,274,165,109,76,25,9,0,63.8,12.2,1,
2017,Los Angeles Chargers,Home,Denver Broncos,21,0,242,162,80,251,182,69,90,15,4,0,63.8,26.2,1,
2017,Los Angeles Chargers,Away,New England Patriots,13,21,349,192,157,414,317,97,62,84,8,1,63.8,1.8,1,
2017,Los Angeles Chargers,Away,Jacksonville Jaguars,17,20,322,235,87,398,263,135,76,75,5,0,63.8,12.2,1,
2017,Los Angeles Chargers,Home,Buffalo Bills,54,24,429,283,146,393,220,173,76,24,6,0,63.8,12.2,1,
2017,Los Angeles Chargers,Home,Cleveland Browns,19,10,429,335,94,291,202,89,68,63,7,0,63.8,4.2,1,
2017,Los Angeles Chargers,Home,Washington Redskins,30,13,488,314,174,201,136,65,81,10,4,0,63.8,17.2,1,
2017,Los Angeles Chargers,Away,Kansas City Chiefs,13,30,307,209,98,397,223,174,53,36,9,0,63.8,10.8,1,
2017,Los Angeles Chargers,Away,New York Jets,14,7,379,290,89,295,98,197,40,55,6,0,63.8,23.8,1,
2017,Los Angeles Chargers,Home,Oakland Raiders,30,10,495,380,115,336,231,105,62,70,2,0,63.8,1.8,1,
2016,Los Angeles Chargers,Home,Kansas City Chiefs,27,37,398,269,129,365,262,103,59,56,10,0,63.8,4.8,1,
2016,Los Angeles Chargers,Away,Kansas City Chiefs,27,33,388,233,155,413,330,83,84,51,9,0,63.8,20.2,1,
2016,Los Angeles Chargers,Home,Jacksonville Jaguars,38,14,357,207,150,388,319,69,82,51,7,0,63.8,18.2,1,
2016,Los Angeles Chargers,Away,Indianapolis Colts,22,26,352,315,37,410,317,93,85,52,8,0,63.8,21.2,1,
2016,Los Angeles Chargers,Home,New Orleans Saints,34,35,346,308,38,275,192,83,57,60,9,0,63.8,6.8,1,
2016,Los Angeles Chargers,Away,Oakland Raiders,31,34,423,351,72,389,300,89,75,39,7,0,63.8,11.2,1,
2016,Los Angeles Chargers,Home,Denver Broncos,21,13,265,166,99,304,220,84,70,63,9,0,63.8,6.2,1,
2016,Los Angeles Chargers,Away,Denver Broncos,19,27,369,246,123,324,267,57,76,19,15,0,63.8,12.2,1,
2016,Los Angeles Chargers,Home,Tennessee Titans,43,35,476,268,208,393,313,80,76,48,6,0,63.8,12.2,1,
2016,Los Angeles Chargers,Home,Miami Dolphins,24,31,379,309,70,337,231,106,85,18,11,0,63.8,21.2,1,
2016,Los Angeles Chargers,Away,Houston Texans,21,13,302,235,67,353,239,114,71,58,14,0,63.8,7.2,1,
2016,Los Angeles Chargers,Home,Tampa Bay Buccaneers,21,28,330,211,119,349,268,81,72,19,7,0,63.8,8.2,1,
2016,Los Angeles Chargers,Away,Carolina Panthers,16,28,278,220,58,272,146,126,37,49,6,0,63.8,26.8,1,
2016,Los Angeles Chargers,Home,Oakland Raiders,16,19,263,190,73,345,200,145,62,22,5,0,63.8,1.8,1,
2016,Los Angeles Chargers,Away,Cleveland Browns,17,20,356,322,34,251,127,124,38,89,13,0,63.8,25.8,1,
2015,Los Angeles Chargers,Away,Denver Broncos,20,27,317,207,110,503,293,210,50,21,5,0,63.8,13.8,1,
2015,Los Angeles Chargers,Home,Detroit Lions,33,28,483,387,96,302,233,69,84,47,10,0,63.8,20.2,1,
2015,Los Angeles Chargers,Away,Cincinnati Bengals,19,24,354,223,131,389,214,175,69,47,6,0,63.8,5.2,1,
2015,Los Angeles Chargers,Away,Minnesota Vikings,14,31,369,279,90,284,121,163,75,50,12,0,63.8,11.2,1,
2015,Los Angeles Chargers,Home,Cleveland Browns,30,27,438,347,91,432,332,100,68,78,11,0,63.8,4.2,1,
2015,Los Angeles Chargers,Home,Pittsburgh Steelers,20,24,406,354,52,349,194,155,93,32,10,0,63.8,29.2,1,
2015,Los Angeles Chargers,Away,Green Bay Packers,20,27,548,488,60,370,237,133,54,35,12,0,63.8,9.8,1,
2015,Los Angeles Chargers,Home,Oakland Raiders,29,37,417,327,90,412,282,130,77,48,4,0,63.8,13.2,1,
2015,Los Angeles Chargers,Away,Baltimore Ravens,26,29,371,290,81,365,293,72,63,72,10,0,63.8,0.8,1,
2015,Los Angeles Chargers,Home,Chicago Bears,19,22,339,262,77,446,337,109,63,67,9,0,63.8,0.8,1,
2015,Los Angeles Chargers,Home,Kansas City Chiefs,3,33,201,149,52,385,232,153,87,12,4,0,63.8,23.2,1,
2015,Los Angeles Chargers,Away,Jacksonville Jaguars,31,25,369,290,79,420,318,102,75,60,8,0,63.8,11.2,1,
2015,Los Angeles Chargers,Home,Denver Broncos,3,17,272,179,93,293,159,134,78,13,4,0,63.8,14.2,1,
2015,Los Angeles Chargers,Away,Kansas City Chiefs,3,10,280,236,44,329,179,150,61,97,14,1,63.8,2.8,1,
2015,Los Angeles Chargers,Home,Miami Dolphins,30,14,442,302,140,231,187,44,61,49,11,0,63.8,2.8,1,
2015,Los Angeles Chargers,Away,Oakland Raiders,20,23,343,271,72,281,175,106,47,70,25,0,63.8,16.8,1,
2018,Los Angeles Rams,Away,Oakland Raiders,33,13,365,225,140,395,300,95,69,58,10,0,63.8,5.2,1,
2018,Los Angeles Rams,Home,Arizona Cardinals,34,0,432,342,90,137,83,54,86,35,2,0,63.8,22.2,1,
2018,Los Angeles Rams,Home,Los Angeles Chargers,35,23,521,350,171,356,215,141,80,50,5,0,63.8,16.2,1,
2018,Los Angeles Rams,Home,Minnesota Vikings,38,31,556,456,100,446,392,54,75,68,3,0,63.8,11.2,1,
2018,Los Angeles Rams,Away,Seattle Seahawks,33,31,468,313,155,373,183,190,53,79,5,1,63.8,10.8,1,
2018,Los Angeles Rams,Away,Denver Broncos,23,20,444,174,270,357,297,60,25,76,6,0,63.8,38.8,1,
2018,Los Angeles Rams,Away,San Francisco 49ers,39,10,339,193,146,228,121,107,62,69,5,0,63.8,1.8,1,
2018,Los Angeles Rams,Home,Green Bay Packers,29,27,416,281,135,359,253,106,82,39,1,0,63.8,18.2,1,
2018,Los Angeles Rams,Away,New Orleans Saints,35,45,483,391,92,487,346,141,77,62,16,0,63.8,13.2,1,
2018,Los Angeles Rams,Home,Seattle Seahawks,36,31,456,307,149,414,141,273,75,20,1,0,63.8,11.2,1,
2018,Los Angeles Rams,Home,Kansas City Chiefs,54,51,455,379,76,546,448,98,65,56,0,0,63.8,1.2,1,
2018,Los Angeles Rams,Away,Detroit Lions,30,16,344,195,149,310,208,102,68,70,0,0,63.8,4.2,1,
2018,Los Angeles Rams,Away,Chicago Bears,6,15,214,162,52,294,100,194,29,70,4,0,63.8,34.8,1,
2018,Los Angeles Rams,Home,Philadelphia Eagles,23,30,407,325,82,381,270,111,60,79,5,0,63.8,3.8,1,
2018,Los Angeles Rams,Away,Arizona Cardinals,31,9,461,192,269,263,159,104,72,22,0,0,63.8,8.2,1,
2018,Los Angeles Rams,Home,San Francisco 49ers,48,32,377,222,155,391,264,127,65,30,3,0,63.8,1.2,1,
2017,Los Angeles Rams,Home,Indianapolis Colts,46,9,373,310,63,225,150,75,90,38,2,0,63.8,26.2,1,
2017,Los Angeles Rams,Home,Washington Redskins,20,27,332,235,97,385,156,229,76,59,3,0,63.8,12.2,1,
2017,Los Angeles Rams,Away,San Francisco 49ers,41,39,418,292,126,421,308,113,68,42,13,0,63.8,4.2,1,
2017,Los Angeles Rams,Home,Seattle Seahawks,10,16,375,275,100,241,179,62,78,50,0,0,63.8,14.2,1,
2017,Los Angeles Rams,Away,Jacksonville Jaguars,27,17,249,107,142,389,220,169,88,68,10,1,63.8,24.2,1,
2017,Los Angeles Rams,Home,Arizona Cardinals,33,0,425,228,197,196,171,25,54,72,10,1,63.8,9.8,1,
2017,Los Angeles Rams,Away,New York Giants,51,17,473,311,162,319,208,111,56,92,6,0,63.8,7.8,1,
2017,Los Angeles Rams,Home,Houston Texans,33,7,443,339,104,283,194,89,68,63,0,0,63.8,4.2,1,
2017,Los Angeles Rams,Away,Minnesota Vikings,7,24,254,209,45,451,280,171,68,70,0,0,63.8,4.2,0,
2017,Los Angeles Rams,Home,New Orleans Saints,26,20,415,327,88,346,223,123,72,56,1,0,63.8,8.2,1,
2017,Los Angeles Rams,Home,Philadelphia Eagles,35,43,307,198,109,455,316,139,83,8,0,0,63.8,19.2,1,
2017,Los Angeles Rams,Away,Seattle Seahawks,42,7,352,108,244,149,71,78,47,88,15,0,63.8,16.8,1,
2017,Los Angeles Rams,Away,Tennessee Titans,27,23,402,286,116,366,269,97,39,90,11,0,63.8,24.8,1,
2017,Los Angeles Rams,Home,San Francisco 49ers,13,34,251,149,102,461,292,169,67,43,3,0,63.8,3.2,1,
2016,Los Angeles Rams,Home,Arizona Cardinals,6,44,123,71,52,344,260,84,59,49,0,0,63.8,4.8,1,
2016,Los Angeles Rams,Away,San Francisco 49ers,0,28,185,120,65,320,170,150,66,56,17,0,63.8,2.2,1,
2016,Los Angeles Rams,Home,Seattle Seahawks,9,3,283,219,64,306,239,67,88,39,3,0,63.8,24.2,1,
2016,Los Angeles Rams,Away,Tampa Bay Buccaneers,37,32,320,183,137,472,389,83,91,58,4,0,63.8,27.2,1,
2016,Los Angeles Rams,Home,Buffalo Bills,19,30,345,243,102,305,112,193,91,18,5,0,63.8,27.2,1,
2016,Los Angeles Rams,Away,Detroit Lions,28,31,387,311,76,348,265,83,68,70,0,0,63.8,4.2,1,
2016,Los Angeles Rams,Home,New York Giants,10,17,345,271,74,232,196,36,55,61,12,0,63.8,8.8,1,
2016,Los Angeles Rams,Home,Carolina Panthers,10,13,339,280,59,244,185,59,75,49,2,0,63.8,11.2,1,
2016,Los Angeles Rams,Away,New York Jets,9,6,280,155,125,296,157,139,62,18,7,0,63.8,1.8,1,
2016,Los Angeles Rams,Home,Miami Dolphins,10,14,227,125,102,240,142,98,63,74,3,1,63.8,0.8,1,
2016,Los Angeles Rams,Away,New Orleans Saints,21,49,247,178,69,555,346,209,61,63,7,0,63.8,2.8,1,
2016,Los Angeles Rams,Away,New England Patriots,10,26,162,126,36,402,269,133,39,43,8,0,63.8,24.8,1,
2016,Los Angeles Rams,Home,Atlanta Falcons,14,42,312,208,104,286,220,66,65,73,1,0,63.8,1.2,1,
2016,Los Angeles Rams,Away,Seattle Seahawks,3,24,183,136,47,299,227,72,36,67,5,0,63.8,27.8,1,
2016,Los Angeles Rams,Home,San Francisco 49ers,21,22,177,78,99,323,253,70,59,44,6,0,63.8,4.8,1,
2015,Los Angeles Rams,Away,San Francisco 49ers,16,19,364,231,133,458,350,108,53,59,6,0,63.8,10.8,1,
2015,Los Angeles Rams,Away,Washington Redskins,10,24,213,146,67,373,191,182,72,56,9,0,63.8,8.2,1,
2015,Los Angeles Rams,Away,Green Bay Packers,10,24,334,143,191,322,236,86,67,51,15,0,63.8,3.2,1,
2015,Los Angeles Rams,Away,Minnesota Vikings,18,21,320,160,160,293,148,145,51,14,26,0,63.8,12.8,1,
2015,Los Angeles Rams,Away,Baltimore Ravens,13,16,213,131,82,388,292,96,47,39,18,0,63.8,16.8,1,
2015,Los Angeles Rams,Away,Cincinnati Bengals,7,31,345,251,94,376,236,140,41,88,8,0,63.8,22.8,1,
2015,Los Angeles Rams,Away,Seattle Seahawks,23,17,205,103,102,312,253,59,37,86,0,0,63.8,26.8,1,
2018,Miami Dolphins,Home,Tennessee Titans,27,20,342,222,120,336,220,116,89,63,7,1,77.05,11.95,1,
2018,Miami Dolphins,Away,New York Jets,20,12,257,122,135,362,320,42,80,63,4,0,77.05,2.95,1,
2018,Miami Dolphins,Home,Oakland Raiders,28,20,373,332,41,434,325,109,90,58,7,0,77.05,12.95,1,
2018,Miami Dolphins,Away,New England Patriots,7,38,172,116,56,449,274,175,65,48,6,0,77.05,12.05,1,
2018,Miami Dolphins,Away,Cincinnati Bengals,17,27,297,169,128,332,229,103,87,52,4,0,77.05,9.95,1,
2018,Miami Dolphins,Home,Chicago Bears,31,28,541,380,161,467,303,164,89,67,8,0,77.05,11.95,1,
2018,Miami Dolphins,Home,Detroit Lions,21,32,322,215,107,457,209,248,89,51,8,0,77.05,11.95,1,
2018,Miami Dolphins,Away,Houston Texans,23,42,370,254,116,427,239,188,66,70,6,0,77.05,11.05,1,
2018,Miami Dolphins,Home,New York Jets,13,6,168,104,64,282,202,80,87,62,16,0,77.05,9.95,1,
2018,Miami Dolphins,Away,Green Bay Packers,12,31,294,163,131,377,182,195,33,66,6,0,77.05,44.05,1,
2018,Miami Dolphins,Away,Indianapolis Colts,24,27,314,201,113,455,337,118,57,74,11,0,77.05,20.05,1,
2018,Miami Dolphins,Home,Buffalo Bills,21,17,175,115,60,415,217,198,86,68,15,0,77.05,8.95,1,
2018,Miami Dolphins,Home,New England Patriots,34,33,412,223,189,421,344,77,82,79,13,0,77.05,4.95,1,
2018,Miami Dolphins,Away,Minnesota Vikings,17,41,193,37,156,418,198,220,68,70,0,0,77.05,9.05,0,
2018,Miami Dolphins,Home,Jacksonville Jaguars,7,17,183,121,62,244,118,126,73,49,9,0,77.05,4.05,1,
2018,Miami Dolphins,Away,Buffalo Bills,17,42,225,126,99,381,215,166,33,75,9,0,77.05,44.05,1,
2017,Miami Dolphins,Away,Los Angeles Chargers,19,17,336,225,111,367,323,44,71,68,7,0,77.05,6.05,1,
2017,Miami Dolphins,Away,New York Jets,6,20,225,195,30,336,233,103,88,41,5,0,77.05,10.95,1,
2017,Miami Dolphins,Home,New Orleans Saints,0,20,186,128,58,347,261,86,63,64,13,0,77.05,14.05,1,
2017,Miami Dolphins,Home,Tennessee Titans,16,10,178,78,100,188,119,69,89,67,9,0,77.05,11.95,1,
2017,Miami Dolphins,Away,Atlanta Falcons,20,17,289,151,138,339,239,100,68,70,0,0,77.05,9.05,0,
2017,Miami Dolphins,Home,New York Jets,31,28,357,304,53,272,180,92,86,67,17,0,77.05,8.95,1,
2017,Miami Dolphins,Away,Baltimore Ravens,0,40,196,151,45,295,121,174,56,49,9,0,77.05,21.05,1,
2017,Miami Dolphins,Home,Oakland Raiders,24,27,395,309,86,379,295,84,77,82,2,0,77.05,0.05,1,
2017,Miami Dolphins,Away,Carolina Panthers,21,45,313,213,100,548,254,294,49,66,6,0,77.05,28.05,1,
2017,Miami Dolphins,Home,Tampa Bay Buccaneers,20,30,448,365,83,321,268,53,81,51,9,0,77.05,3.95,1,
2017,Miami Dolphins,Away,New England Patriots,17,35,221,154,67,417,221,196,47,37,17,0,77.05,30.05,1,
2017,Miami Dolphins,Home,Denver Broncos,35,9,367,222,145,270,167,103,80,58,11,0,77.05,2.95,1,
2017,Miami Dolphins,Home,New England Patriots,27,20,362,242,120,248,223,25,55,59,7,0,77.05,22.05,1,
2017,Miami Dolphins,Away,Buffalo Bills,16,24,349,249,100,328,212,116,22,71,8,0,77.05,55.05,1,
2017,Miami Dolphins,Away,Kansas City Chiefs,13,29,345,286,59,404,301,103,23,71,15,0,77.05,54.05,1,
2017,Miami Dolphins,Home,Buffalo Bills,16,22,356,263,93,312,186,126,71,66,9,0,77.05,6.05,1,
2016,Miami Dolphins,Home,New England Patriots,14,35,280,205,75,396,276,120,80,62,15,0,77.05,2.95,1,
2016,Miami Dolphins,Away,Seattle Seahawks,10,12,214,150,64,352,240,112,61,68,2,0,77.05,16.05,1,
2016,Miami Dolphins,Away,New England Patriots,24,31,457,387,70,463,302,161,79,66,10,1,77.05,1.95,1,
2016,Miami Dolphins,Home,Cleveland Browns,30,24,426,311,115,430,261,169,86,65,16,0,77.05,8.95,1,
2016,Miami Dolphins,Away,Cincinnati Bengals,7,22,222,160,62,362,285,77,62,77,2,0,77.05,15.05,1,
2016,Miami Dolphins,Home,Tennessee Titans,17,30,200,149,51,398,163,235,88,53,13,0,77.05,10.95,1,
2016,Miami Dolphins,Home,Pittsburgh Steelers,30,15,474,252,222,297,169,128,81,79,15,0,77.05,3.95,1,
2016,Miami Dolphins,Home,Buffalo Bills,28,25,454,198,256,267,200,67,81,48,11,0,77.05,3.95,1,
2016,Miami Dolphins,Home,New York Jets,27,23,274,137,137,331,191,140,80,58,14,0,77.05,2.95,1,
2016,Miami Dolphins,Away,San Diego Chargers,31,24,337,231,106,379,309,70,85,18,11,0,77.05,7.95,1,
2016,Miami Dolphins,Away,Los Angeles Rams,14,10,240,142,98,227,125,102,63,74,3,1,77.05,14.05,1,
2016,Miami Dolphins,Home,San Francisco 49ers,31,24,358,263,95,475,282,193,79,49,13,0,77.05,1.95,1,
2016,Miami Dolphins,Away,Baltimore Ravens,6,38,277,215,62,496,386,110,47,67,3,0,77.05,30.05,1,
2016,Miami Dolphins,Home,Arizona Cardinals,26,23,314,231,83,300,125,175,77,87,18,0,77.05,0.05,1,
2016,Miami Dolphins,Away,New York Jets,34,13,303,236,67,360,244,116,32,92,5,0,77.05,45.05,1,
2016,Miami Dolphins,Away,Buffalo Bills,34,31,494,233,261,589,317,272,38,86,13,0,77.05,39.05,1,
2015,Miami Dolphins,Home,New England Patriots,20,10,438,342,96,196,126,70,80,65,7,0,77.05,2.95,1,
2015,Miami Dolphins,Away,Washington Redskins,17,10,256,182,74,349,188,161,69,58,10,0,77.05,8.05,1,
2015,Miami Dolphins,Away,Jacksonville Jaguars,20,23,386,344,42,396,273,123,87,57,5,0,77.05,9.95,1,
2015,Miami Dolphins,Home,Buffalo Bills,14,41,391,289,102,428,277,151,87,65,6,0,77.05,9.95,1,
2015,Miami Dolphins,Home,New York Jets,14,27,226,167,59,425,218,207,59,63,5,0,77.05,18.05,1,
2015,Miami Dolphins,Away,Tennessee Titans,38,10,434,254,180,299,236,63,56,39,8,0,77.05,21.05,1,
2015,Miami Dolphins,Home,Houston Texans,44,26,503,255,248,322,251,71,84,62,13,0,77.05,6.95,1,
2015,Miami Dolphins,Away,New England Patriots,7,36,270,255,15,437,342,95,58,39,10,0,77.05,19.05,1,
2015,Miami Dolphins,Away,Buffalo Bills,17,33,397,289,108,420,154,266,49,55,7,0,77.05,28.05,1,
2015,Miami Dolphins,Away,Philadelphia Eagles,20,19,289,190,99,436,353,83,59,34,13,0,77.05,18.05,1,
2015,Miami Dolphins,Home,Dallas Cowboys,14,24,210,140,70,386,220,166,74,90,10,0,77.05,3.05,1,
2015,Miami Dolphins,Away,New York Jets,20,38,333,321,12,411,274,137,45,44,5,0,77.05,32.05,1,
2015,Miami Dolphins,Home,Baltimore Ravens,15,13,219,82,137,375,281,94,80,70,21,0,77.05,2.95,1,
2015,Miami Dolphins,Home,New York Giants,24,31,363,235,128,429,337,92,77,78,6,0,77.05,0.05,1,
2015,Miami Dolphins,Away,San Diego Chargers,14,30,231,187,44,442,302,140,61,49,11,0,77.05,16.05,1,
2015,Miami Dolphins,Home,Indianapolis Colts,12,18,361,279,82,268,168,100,82,69,15,0,77.05,4.95,1,
2018,Minnesota Vikings,Home,San Francisco 49ers,24,16,343,227,116,327,237,90,68,70,0,0,46.15,21.85,0,
2018,Minnesota Vikings,Away,Green Bay Packers,29,29,480,412,68,351,253,98,80,71,5,0,46.15,33.85,1,
2018,Minnesota Vikings,Home,Buffalo Bills,6,27,292,278,14,292,164,128,68,70,0,0,46.15,21.85,0,
2018,Minnesota Vikings,Away,Los Angeles Rams,31,38,446,392,54,556,456,100,75,68,3,0,46.15,28.85,1,
2018,Minnesota Vikings,Away,Philadelphia Eagles,23,21,375,298,77,364,283,81,79,77,6,0,46.15,32.85,1,
2018,Minnesota Vikings,Home,Arizona Cardinals,27,17,411,216,195,268,208,60,68,70,0,0,46.15,21.85,0,
2018,Minnesota Vikings,Away,New York Jets,37,17,316,228,88,263,192,71,46,48,16,0,46.15,0.15,1,
2018,Minnesota Vikings,Home,New Orleans Saints,20,30,423,338,85,270,164,106,68,70,0,0,46.15,21.85,0,
2018,Minnesota Vikings,Home,Detroit Lions,24,9,283,155,128,209,143,66,68,70,0,0,46.15,21.85,0,
2018,Minnesota Vikings,Away,Chicago Bears,20,25,268,246,22,308,160,148,33,77,6,0,46.15,13.15,1,
2018,Minnesota Vikings,Home,Green Bay Packers,24,17,416,325,91,254,172,82,68,70,0,0,46.15,21.85,0,
2018,Minnesota Vikings,Away,New England Patriots,10,24,278,183,95,471,311,160,53,100,6,0,46.15,6.85,1,
2018,Minnesota Vikings,Away,Seattle Seahawks,7,21,276,199,77,274,60,214,48,76,9,0,46.15,1.85,1,
2018,Minnesota Vikings,Home,Miami Dolphins,41,17,418,198,220,193,37,156,68,70,0,0,46.15,21.85,0,
2018,Minnesota Vikings,Away,Detroit Lions,27,9,340,240,100,223,137,86,68,70,0,0,46.15,21.85,1,
2018,Minnesota Vikings,Home,Chicago Bears,10,24,164,101,63,332,163,169,68,70,0,0,46.15,21.85,0,
2017,Minnesota Vikings,Home,New Orleans Saints,29,19,470,341,129,344,284,60,68,70,0,0,46.15,21.85,0,
2017,Minnesota Vikings,Away,Pittsburgh Steelers,9,26,237,146,91,335,233,102,78,64,1,0,46.15,31.85,1,
2017,Minnesota Vikings,Home,Tampa Bay Buccaneers,34,17,494,369,125,342,316,26,68,70,0,0,46.15,21.85,0,
2017,Minnesota Vikings,Home,Detroit Lions,7,14,284,197,87,251,154,97,68,70,0,0,46.15,21.85,0,
2017,Minnesota Vikings,Away,Chicago Bears,20,17,300,141,159,274,159,115,70,69,10,0,46.15,23.85,1,
2017,Minnesota Vikings,Home,Green Bay Packers,23,10,351,239,112,227,155,72,68,70,0,0,46.15,21.85,0,
2017,Minnesota Vikings,Home,Baltimore Ravens,24,16,357,188,169,208,144,64,68,70,0,0,46.15,21.85,0,
2017,Minnesota Vikings,Away,Cleveland Browns,33,16,375,287,88,276,161,115,56,56,11,0,46.15,9.85,1,
2017,Minnesota Vikings,Away,Washington Redskins,38,30,406,304,102,394,313,81,44,44,4,0,46.15,2.15,1,
2017,Minnesota Vikings,Home,Los Angeles Rams,24,7,451,280,171,254,209,45,68,70,0,0,46.15,21.85,0,
2017,Minnesota Vikings,Away,Detroit Lions,30,23,408,272,136,289,236,53,68,70,0,0,46.15,21.85,1,
2017,Minnesota Vikings,Away,Carolina Panthers,24,31,356,256,100,345,129,216,41,49,5,0,46.15,5.15,1,
2017,Minnesota Vikings,Home,Cincinnati Bengals,34,7,346,222,124,161,115,46,68,70,0,0,46.15,21.85,0,
2017,Minnesota Vikings,Away,Green Bay Packers,16,0,236,124,112,239,126,113,10,67,6,0,46.15,36.15,1,
2017,Minnesota Vikings,Home,Chicago Bears,23,10,327,180,147,201,171,30,68,70,0,0,46.15,21.85,0,
2016,Minnesota Vikings,Home,Chicago Bears,38,10,374,250,124,323,140,183,68,70,0,0,46.15,21.85,0,
2016,Minnesota Vikings,Away,Tennessee Titans,25,16,301,236,65,316,252,64,76,47,5,0,46.15,29.85,1,
2016,Minnesota Vikings,Home,Green Bay Packers,17,14,284,254,30,263,180,83,68,70,0,0,46.15,21.85,0,
2016,Minnesota Vikings,Away,Carolina Panthers,22,10,211,153,58,306,201,105,80,63,0,0,46.15,33.85,1,
2016,Minnesota Vikings,Home,New York Giants,24,10,366,262,104,339,261,78,68,70,0,0,46.15,21.85,0,
2016,Minnesota Vikings,Home,Houston Texans,31,13,351,255,96,214,155,59,68,70,0,0,46.15,21.85,0,
2016,Minnesota Vikings,Away,Philadelphia Eagles,10,21,282,189,93,239,138,101,62,46,20,0,46.15,15.85,1,
2016,Minnesota Vikings,Away,Chicago Bears,10,20,258,201,57,403,245,158,58,71,12,0,46.15,11.85,1,
2016,Minnesota Vikings,Home,Detroit Lions,16,22,337,259,78,311,214,97,68,70,0,0,46.15,21.85,0,
2016,Minnesota Vikings,Away,Washington Redskins,20,26,331,284,47,388,260,128,58,24,7,0,46.15,11.85,1,
2016,Minnesota Vikings,Home,Arizona Cardinals,30,24,217,145,72,290,155,135,68,70,0,0,46.15,21.85,0,
2016,Minnesota Vikings,Away,Detroit Lions,13,16,306,224,82,308,214,94,68,70,0,0,46.15,21.85,1,
2016,Minnesota Vikings,Home,Dallas Cowboys,15,17,318,231,87,264,124,140,68,70,0,0,46.15,21.85,0,
2016,Minnesota Vikings,Away,Jacksonville Jaguars,25,16,377,292,85,315,230,85,71,70,5,0,46.15,24.85,1,
2016,Minnesota Vikings,Home,Indianapolis Colts,6,34,282,248,34,411,250,161,68,70,0,0,46.15,21.85,0,
2016,Minnesota Vikings,Away,Green Bay Packers,25,38,446,353,93,348,308,40,37,78,8,0,46.15,9.15,1,
2015,Minnesota Vikings,Away,Green Bay Packers,20,13,242,91,151,350,274,76,24,70,11,0,46.15,22.15,1,
2015,Minnesota Vikings,Away,San Francisco 49ers,3,20,248,177,71,395,165,230,70,63,5,0,46.15,23.85,1,
2015,Minnesota Vikings,Home,Detroit Lions,26,16,350,151,199,323,285,38,67,50,0,0,46.15,20.85,1,
2015,Minnesota Vikings,Home,San Diego Chargers,31,14,284,121,163,369,279,90,75,50,12,0,46.15,28.85,1,
2015,Minnesota Vikings,Away,Denver Broncos,20,23,325,212,113,344,200,144,60,57,9,0,46.15,13.85,1,
2015,Minnesota Vikings,Home,Kansas City Chiefs,16,10,321,237,84,328,271,57,54,50,10,0,46.15,7.85,1,
2015,Minnesota Vikings,Away,Detroit Lions,28,19,425,285,140,274,197,77,68,70,0,0,46.15,21.85,1,
2015,Minnesota Vikings,Away,Chicago Bears,23,20,327,180,147,305,208,97,62,42,11,0,46.15,15.85,1,
2015,Minnesota Vikings,Home,St. Louis Rams,21,18,293,148,145,320,160,160,51,14,26,0,46.15,4.85,1,
2015,Minnesota Vikings,Away,Oakland Raiders,30,14,385,122,263,371,287,84,62,50,31,0,46.15,15.85,1,
2015,Minnesota Vikings,Home,Green Bay Packers,13,30,342,248,94,320,196,124,30,50,8,0,46.15,16.15,1,
2015,Minnesota Vikings,Home,Seattle Seahawks,7,38,125,94,31,433,260,173,37,86,3,0,46.15,9.15,1,
2015,Minnesota Vikings,Away,Arizona Cardinals,20,23,389,317,72,393,296,97,68,26,1,0,46.15,21.85,1,
2015,Minnesota Vikings,Home,Chicago Bears,38,17,350,221,129,293,199,94,36,50,3,0,46.15,10.15,1,
2015,Minnesota Vikings,Home,New York Giants,49,17,368,150,218,363,272,91,13,50,8,0,46.15,33.15,1,
2018,New England Patriots,Home,Houston Texans,27,20,389,267,122,325,158,167,62,61,10,0,51.4,10.6,1,
2018,New England Patriots,Away,Jacksonville Jaguars,20,31,302,220,82,480,376,104,97,46,20,1,51.4,45.6,1,
2018,New England Patriots,Away,Detroit Lions,10,26,209,120,89,414,255,159,68,70,0,0,51.4,16.6,1,
2018,New England Patriots,Home,Miami Dolphins,38,7,449,274,175,172,116,56,65,48,6,0,51.4,13.6,1,
2018,New England Patriots,Home,Indianapolis Colts,38,24,438,341,97,439,355,84,66,96,6,0,51.4,14.6,1,
2018,New England Patriots,Home,Kansas City Chiefs,43,40,500,327,173,446,352,94,45,85,0,0,51.4,6.4,1,
2018,New England Patriots,Away,Chicago Bears,38,31,381,273,108,453,319,134,44,42,9,0,51.4,7.4,1,
2018,New England Patriots,Away,Buffalo Bills,25,6,387,311,76,333,287,46,46,58,16,0,51.4,5.4,1,
2018,New England Patriots,Home,Green Bay Packers,31,17,433,310,123,367,250,117,40,76,2,0,51.4,11.4,1,
2018,New England Patriots,Away,Tennessee Titans,10,34,284,244,40,385,235,150,46,42,4,0,51.4,5.4,1,
2018,New England Patriots,Away,New York Jets,27,13,498,283,215,338,264,74,54,64,8,0,51.4,2.6,1,
2018,New England Patriots,Home,Minnesota Vikings,24,10,471,311,160,278,183,95,53,100,6,0,51.4,1.6,1,
2018,New England Patriots,Away,Miami Dolphins,33,34,421,344,77,412,223,189,82,79,13,0,51.4,30.6,1,
2018,New England Patriots,Away,Pittsburgh Steelers,10,17,368,272,96,376,218,158,42,90,5,0,51.4,9.4,1,
2018,New England Patriots,Home,Buffalo Bills,24,12,390,117,273,289,217,72,40,38,12,0,51.4,11.4,1,
2018,New England Patriots,Home,New York Jets,38,3,375,244,131,239,135,104,33,42,2,0,51.4,18.4,1,
2017,New England Patriots,Away,New Orleans Saints,36,20,555,436,119,429,348,81,85,75,7,0,51.4,33.6,1,
2017,New England Patriots,Home,Houston Texans,36,33,396,337,59,417,292,125,84,53,4,0,51.4,32.6,1,
2017,New England Patriots,Home,Carolina Panthers,30,33,373,293,80,444,304,140,61,43,6,0,51.4,9.6,1,
2017,New England Patriots,Away,Tampa Bay Buccaneers,19,14,402,289,113,409,319,90,76,94,9,0,51.4,24.6,1,
2017,New England Patriots,Away,New York Jets,24,17,375,257,118,408,334,74,73,70,13,0,51.4,21.6,1,
2017,New England Patriots,Home,Atlanta Falcons,23,7,403,241,162,343,223,120,56,88,2,0,51.4,4.6,1,
2017,New England Patriots,Home,Los Angeles Chargers,21,13,414,317,97,349,192,157,62,84,8,1,51.4,10.6,1,
2017,New England Patriots,Away,Denver Broncos,41,16,396,297,99,339,221,118,48,40,5,0,51.4,3.4,1,
2017,New England Patriots,Away,Oakland Raiders,33,8,421,332,89,344,235,109,66,42,0,0,51.4,14.6,1,
2017,New England Patriots,Home,Miami Dolphins,35,17,417,221,196,221,154,67,47,37,17,0,51.4,4.4,1,
2017,New England Patriots,Away,Buffalo Bills,23,3,435,244,191,268,85,183,48,73,13,0,51.4,3.4,1,
2017,New England Patriots,Away,Miami Dolphins,20,27,248,223,25,362,242,120,55,59,7,0,51.4,3.6,1,
2017,New England Patriots,Away,Pittsburgh Steelers,27,24,360,283,77,413,270,143,42,62,4,0,51.4,9.4,1,
2017,New England Patriots,Home,Buffalo Bills,37,16,411,218,193,326,242,84,35,67,7,0,51.4,16.4,1,
2017,New England Patriots,Home,New York Jets,26,6,330,183,147,247,207,40,13,42,14,0,51.4,38.4,1,
2016,New England Patriots,Away,Miami Dolphins,35,14,396,276,120,280,205,75,80,62,15,0,51.4,28.6,1,
2016,New England Patriots,Home,Miami Dolphins,31,24,463,302,161,457,387,70,79,66,10,1,51.4,27.6,1,
2016,New England Patriots,Home,Houston Texans,27,0,282,97,185,284,175,109,68,60,4,0,51.4,16.6,1,
2016,New England Patriots,Home,Buffalo Bills,0,16,277,187,90,378,244,134,56,91,7,0,51.4,4.6,1,
2016,New England Patriots,Away,Cleveland Browns,33,13,501,403,98,262,235,27,58,58,13,0,51.4,6.6,1,
2016,New England Patriots,Home,Cincinnati Bengals,35,17,437,358,79,357,237,120,66,54,14,0,51.4,14.6,1,
2016,New England Patriots,Away,Pittsburgh Steelers,27,16,362,222,140,375,281,94,64,53,14,0,51.4,12.6,1,
2016,New England Patriots,Away,Buffalo Bills,41,25,357,285,72,376,209,167,49,92,9,1,51.4,2.4,1,
2016,New England Patriots,Home,Seattle Seahawks,24,31,385,304,81,420,324,96,43,55,3,0,51.4,8.4,1,
2016,New England Patriots,Away,San Francisco 49ers,30,17,444,273,171,299,177,122,64,64,6,1,51.4,12.6,1,
2016,New England Patriots,Away,New York Jets,22,17,377,286,91,333,269,64,47,43,10,0,51.4,4.4,1,
2016,New England Patriots,Home,Los Angeles Rams,26,10,402,269,133,162,126,36,39,43,8,0,51.4,12.4,1,
2016,New England Patriots,Home,Baltimore Ravens,30,23,496,401,95,348,306,42,31,91,3,0,51.4,20.4,1,
2016,New England Patriots,Away,Denver Broncos,16,3,313,177,136,309,251,58,18,52,9,0,51.4,33.4,1,
2016,New England Patriots,Home,New York Jets,41,3,325,211,114,239,128,111,40,95,6,1,51.4,11.4,1,
2015,New England Patriots,Away,Miami Dolphins,10,20,196,126,70,438,342,96,80,65,7,0,51.4,28.6,1,
2015,New England Patriots,Home,Pittsburgh Steelers,28,21,361,281,80,464,330,134,65,100,7,1,51.4,13.6,1,
2015,New England Patriots,Away,Buffalo Bills,40,32,507,451,56,349,189,160,52,67,10,0,51.4,0.6,1,
2015,New England Patriots,Home,Jacksonville Jaguars,51,17,471,346,125,293,236,57,68,41,6,0,51.4,16.6,1,
2015,New England Patriots,Away,Indianapolis Colts,34,27,417,301,116,409,289,120,52,30,4,0,51.4,0.6,1,
2015,New England Patriots,Home,New York Jets,30,23,353,337,16,372,283,89,58,80,9,0,51.4,6.6,1,
2015,New England Patriots,Home,Miami Dolphins,36,7,437,342,95,270,255,15,58,39,10,0,51.4,6.6,1,
2015,New England Patriots,Home,Washington Redskins,27,10,460,299,161,250,213,37,54,34,12,0,51.4,2.6,1,
2015,New England Patriots,Away,New York Giants,27,26,406,329,77,422,342,80,60,31,8,0,51.4,8.6,1,
2015,New England Patriots,Home,Buffalo Bills,20,13,356,271,85,319,225,94,29,40,8,0,51.4,22.4,1,
2015,New England Patriots,Away,Denver Broncos,24,30,301,262,39,433,254,179,23,75,3,1,51.4,28.4,1,
2015,New England Patriots,Home,Philadelphia Eagles,28,35,427,324,103,248,120,128,52,49,5,0,51.4,0.6,1,
2015,New England Patriots,Away,Houston Texans,27,6,313,197,116,189,102,87,54,90,5,0,51.4,2.6,1,
2015,New England Patriots,Home,Tennessee Titans,33,16,346,253,93,282,223,59,40,41,12,0,51.4,11.4,1,
2015,New England Patriots,Away,New York Jets,20,26,284,221,63,428,285,143,57,83,15,0,51.4,5.6,1,
2018,New Orleans Saints,Home,Tampa Bay Buccaneers,40,48,475,432,43,529,417,112,86,67,5,0,69.55,16.45,1,
2018,New Orleans Saints,Home,Cleveland Browns,21,18,275,213,62,327,234,93,90,68,1,0,69.55,20.45,1,
2018,New Orleans Saints,Away,New York Giants,33,18,389,219,170,299,234,65,71,54,7,0,69.55,1.45,1,
2018,New Orleans Saints,Home,Washington Redskins,43,19,447,349,98,283,244,39,84,70,22,0,69.55,14.45,1,
2018,New Orleans Saints,Away,Baltimore Ravens,24,23,339,205,134,351,274,77,54,34,15,0,69.55,15.55,1,
2018,New Orleans Saints,Away,Minnesota Vikings,30,20,270,164,106,423,338,85,68,70,0,0,69.55,1.55,0,
2018,New Orleans Saints,Home,Los Angeles Rams,45,35,487,346,141,483,391,92,77,62,16,0,69.55,7.45,1,
2018,New Orleans Saints,Away,Cincinnati Bengals,51,14,509,265,244,284,174,110,39,51,6,0,69.55,30.55,1,
2018,New Orleans Saints,Home,Philadelphia Eagles,48,7,546,373,173,196,138,58,68,54,4,0,69.55,1.55,1,
2018,New Orleans Saints,Home,Atlanta Falcons,31,17,312,162,150,366,340,26,53,72,5,0,69.55,16.55,1,
2018,New Orleans Saints,Away,Dallas Cowboys,10,13,176,111,65,308,209,99,70,59,10,0,69.55,0.45,1,
2018,New Orleans Saints,Away,Tampa Bay Buccaneers,28,14,298,198,100,279,174,105,71,91,7,0,69.55,1.45,1,
2018,New Orleans Saints,Away,Carolina Panthers,12,9,346,191,155,247,149,98,48,45,3,0,69.55,21.55,1,
2018,New Orleans Saints,Home,Pittsburgh Steelers,31,28,370,313,57,429,364,65,68,71,10,0,69.55,1.55,1,
2018,New Orleans Saints,Home,Carolina Panthers,14,33,294,110,184,374,263,111,64,98,5,0,69.55,5.55,1,
2017,New Orleans Saints,Away,Minnesota Vikings,19,29,344,284,60,470,341,129,68,70,0,0,69.55,1.55,0,
2017,New Orleans Saints,Home,New England Patriots,20,36,429,348,81,555,436,119,85,75,7,0,69.55,15.45,1,
2017,New Orleans Saints,Away,Carolina Panthers,34,13,362,213,149,288,156,132,82,59,6,0,69.55,12.45,1,
2017,New Orleans Saints,Away,Miami Dolphins,20,0,347,261,86,186,128,58,63,64,13,0,69.55,6.55,1,
2017,New Orleans Saints,Home,Detroit Lions,52,38,379,186,193,347,281,66,84,80,2,0,69.55,14.45,1,
2017,New Orleans Saints,Away,Green Bay Packers,26,17,485,324,161,260,79,181,52,100,10,1,69.55,17.55,1,
2017,New Orleans Saints,Home,Chicago Bears,20,12,387,286,101,307,150,157,54,47,4,0,69.55,15.55,1,
2017,New Orleans Saints,Home,Tampa Bay Buccaneers,30,10,407,256,151,200,113,87,79,67,1,0,69.55,9.45,1,
2017,New Orleans Saints,Away,Buffalo Bills,47,10,482,184,298,198,129,69,42,50,2,0,69.55,27.55,1,
2017,New Orleans Saints,Home,Washington Redskins,34,31,535,375,160,456,300,156,57,44,12,0,69.55,12.55,1,
2017,New Orleans Saints,Away,Los Angeles Rams,20,26,346,223,123,415,327,88,72,56,1,0,69.55,2.45,1,
2017,New Orleans Saints,Home,Carolina Panthers,31,21,400,252,148,279,167,112,69,66,7,0,69.55,0.55,1,
2017,New Orleans Saints,Home,New York Jets,31,19,412,281,131,294,170,124,67,97,4,1,69.55,2.55,1,
2017,New Orleans Saints,Home,Atlanta Falcons,23,13,315,229,86,331,264,67,56,71,4,0,69.55,13.55,1,
2017,New Orleans Saints,Away,Tampa Bay Buccaneers,24,31,323,231,92,455,345,110,71,49,3,0,69.55,1.45,1,
2016,New Orleans Saints,Home,Oakland Raiders,34,35,507,419,88,486,319,167,87,69,4,0,69.55,17.45,1,
2016,New Orleans Saints,Away,New York Giants,13,16,288,247,41,417,353,64,80,74,5,0,69.55,10.45,1,
2016,New Orleans Saints,Home,Atlanta Falcons,32,45,474,359,115,442,225,217,90,53,4,0,69.55,20.45,1,
2016,New Orleans Saints,Away,San Diego Chargers,35,34,275,192,83,346,308,38,57,60,9,0,69.55,12.55,1,
2016,New Orleans Saints,Home,Carolina Panthers,41,38,523,460,63,406,303,103,80,75,7,0,69.55,10.45,1,
2016,New Orleans Saints,Away,Kansas City Chiefs,21,27,463,359,104,326,214,112,68,47,9,0,69.55,1.55,1,
2016,New Orleans Saints,Home,Seattle Seahawks,25,20,375,252,123,359,285,74,80,60,5,0,69.55,10.45,1,
2016,New Orleans Saints,Away,San Francisco 49ers,41,23,571,323,248,486,393,93,70,60,0,0,69.55,0.45,1,
2016,New Orleans Saints,Home,Denver Broncos,23,25,373,293,80,337,234,103,62,62,6,0,69.55,7.55,1,
2016,New Orleans Saints,Away,Carolina Panthers,20,23,371,264,107,223,173,50,63,43,6,0,69.55,6.55,1,
2016,New Orleans Saints,Home,Los Angeles Rams,49,21,555,346,209,247,178,69,61,63,7,0,69.55,8.55,1,
2016,New Orleans Saints,Home,Detroit Lions,13,28,369,319,50,422,337,85,68,93,5,0,69.55,1.55,1,
2016,New Orleans Saints,Away,Tampa Bay Buccaneers,11,16,294,248,46,270,166,104,79,69,9,0,69.55,9.45,1,
2016,New Orleans Saints,Away,Arizona Cardinals,48,41,488,358,130,425,309,116,62,20,2,0,69.55,7.55,1,
2016,New Orleans Saints,Home,Tampa Bay Buccaneers,31,24,417,294,123,349,260,89,76,74,7,0,69.55,6.45,1,
2015,New Orleans Saints,Home,Tampa Bay Buccaneers,19,26,323,219,104,333,194,139,86,62,4,0,69.55,16.45,1,
2015,New Orleans Saints,Away,Carolina Panthers,22,27,380,310,70,431,312,119,69,90,9,0,69.55,0.55,1,
2015,New Orleans Saints,Home,Dallas Cowboys,26,20,438,335,103,335,220,115,67,67,12,0,69.55,2.55,1,
2015,New Orleans Saints,Away,Philadelphia Eagles,17,39,388,292,96,519,333,186,67,54,6,0,69.55,2.55,1,
2015,New Orleans Saints,Home,Atlanta Falcons,31,21,385,304,81,413,263,150,83,33,9,0,69.55,13.45,1,
2015,New Orleans Saints,Away,Indianapolis Colts,27,21,449,266,183,376,301,75,55,56,12,0,69.55,14.55,1,
2015,New Orleans Saints,Home,New York Giants,52,49,608,505,103,416,329,87,65,95,13,1,69.55,4.55,1,
2015,New Orleans Saints,Home,Tennessee Titans,28,34,416,355,61,483,371,112,60,90,17,0,69.55,9.55,1,
2015,New Orleans Saints,Away,Washington Redskins,14,47,350,192,158,510,301,209,61,29,5,0,69.55,8.55,1,
2015,New Orleans Saints,Away,Houston Texans,6,24,268,218,50,362,195,167,54,90,9,0,69.55,15.55,1,
2015,New Orleans Saints,Home,Carolina Panthers,38,41,334,264,70,497,322,175,69,60,7,0,69.55,0.55,1,
2015,New Orleans Saints,Away,Tampa Bay Buccaneers,24,17,388,301,87,291,176,115,81,63,15,0,69.55,11.45,1,
2015,New Orleans Saints,Home,Detroit Lions,27,35,399,330,69,396,246,150,69,95,5,1,69.55,0.55,1,
2015,New Orleans Saints,Home,Jacksonville Jaguars,38,27,537,402,135,412,347,65,78,75,19,0,69.55,8.45,1,
2018,New York Giants,Home,Jacksonville Jaguars,15,20,324,210,114,305,168,137,59,85,7,1,55.15,3.85,1,
2018,New York Giants,Away,Houston Texans,27,22,379,265,114,427,368,59,78,72,2,0,55.15,22.85,1,
2018,New York Giants,Home,New Orleans Saints,18,33,299,234,65,389,219,170,71,54,7,0,55.15,15.85,1,
2018,New York Giants,Away,Carolina Panthers,31,33,432,382,50,350,232,118,80,83,3,0,55.15,24.85,1,
2018,New York Giants,Home,Philadelphia Eagles,13,34,401,254,147,379,271,108,70,98,3,0,55.15,14.85,1,
2018,New York Giants,Away,Atlanta Falcons,20,23,433,372,61,423,356,67,60,49,2,0,55.15,4.85,1,
2018,New York Giants,Home,Washington Redskins,13,20,303,266,37,360,178,182,51,73,11,0,55.15,4.15,1,
2018,New York Giants,Away,San Francisco 49ers,27,23,277,180,97,374,250,124,62,22,0,0,55.15,6.85,1,
2018,New York Giants,Home,Tampa Bay Buccaneers,38,35,359,196,163,510,359,151,42,54,1,0,55.15,13.15,1,
2018,New York Giants,Away,Philadelphia Eagles,22,25,402,276,126,341,214,127,56,58,10,0,55.15,0.85,1,
2018,New York Giants,Home,Chicago Bears,30,27,338,197,141,376,258,118,52,92,3,0,55.15,3.15,1,
2018,New York Giants,Away,Washington Redskins,40,16,402,175,227,288,204,84,33,57,6,0,55.15,22.15,1,
2018,New York Giants,Home,Tennessee Titans,0,17,260,213,47,301,86,215,40,95,6,1,55.15,15.15,1,
2018,New York Giants,Away,Indianapolis Colts,27,28,392,309,83,402,353,49,33,85,7,0,55.15,22.15,1,
2018,New York Giants,Home,Dallas Cowboys,35,36,441,298,143,419,368,51,37,70,2,0,55.15,18.15,1,
2017,New York Giants,Home,Detroit Lions,10,24,270,208,62,257,119,138,72,80,5,0,55.15,16.85,1,
2017,New York Giants,Away,Philadelphia Eagles,24,27,415,366,49,354,161,193,89,48,6,0,55.15,33.85,1,
2017,New York Giants,Away,Tampa Bay Buccaneers,23,25,379,288,91,434,323,111,91,51,8,0,55.15,35.85,1,
2017,New York Giants,Home,Los Angeles Chargers,22,27,335,183,152,382,258,124,76,90,7,0,55.15,20.85,1,
2017,New York Giants,Away,Denver Broncos,23,10,266,118,148,412,366,46,61,17,4,0,55.15,5.85,1,
2017,New York Giants,Home,Seattle Seahawks,7,24,177,131,46,425,321,104,75,29,7,0,55.15,19.85,1,
2017,New York Giants,Home,Los Angeles Rams,17,51,319,208,111,473,311,162,56,92,6,0,55.15,0.85,1,
2017,New York Giants,Away,San Francisco 49ers,21,31,374,260,114,474,288,186,68,46,5,0,55.15,12.85,1,
2017,New York Giants,Home,Kansas City Chiefs,12,9,317,205,112,363,229,134,50,44,23,0,55.15,5.15,1,
2017,New York Giants,Away,Washington Redskins,10,20,170,86,84,323,201,122,33,67,0,0,55.15,22.15,1,
2017,New York Giants,Away,Oakland Raiders,17,24,265,200,65,401,282,119,58,51,11,0,55.15,2.85,1,
2017,New York Giants,Home,Dallas Cowboys,10,30,330,228,102,454,332,122,39,55,11,0,55.15,16.15,1,
2017,New York Giants,Home,Philadelphia Eagles,29,34,504,429,75,341,233,108,35,58,5,0,55.15,20.15,1,
2017,New York Giants,Away,Arizona Cardinals,0,23,293,250,43,289,215,74,71,14,3,0,55.15,15.85,1,
2017,New York Giants,Home,Washington Redskins,18,10,381,121,260,197,136,61,16,42,16,0,55.15,39.15,1,
2016,New York Giants,Away,Washington Redskins,19,10,332,171,161,284,246,38,53,51,1,0,55.15,2.15,1,
2016,New York Giants,Home,New Orleans Saints,16,13,417,353,64,288,247,41,80,74,5,0,55.15,24.85,1,
2016,New York Giants,Home,Washington Redskins,27,29,457,337,120,403,313,90,67,37,2,0,55.15,11.85,1,
2016,New York Giants,Away,Minnesota Vikings,10,24,339,261,78,366,262,104,68,70,0,0,55.15,12.85,0,
2016,New York Giants,Away,Green Bay Packers,16,23,221,178,43,406,259,147,49,50,7,0,55.15,6.15,1,
2016,New York Giants,Home,Baltimore Ravens,27,23,435,397,38,391,293,98,65,66,6,0,55.15,9.85,1,
2016,New York Giants,Away,Los Angeles Rams,17,10,232,196,36,345,271,74,55,61,12,0,55.15,0.15,1,
2016,New York Giants,Home,Philadelphia Eagles,28,23,302,248,54,443,347,96,56,41,9,0,55.15,0.85,1,
2016,New York Giants,Home,Cincinnati Bengals,21,20,351,229,122,264,186,78,56,35,2,0,55.15,0.85,1,
2016,New York Giants,Home,Chicago Bears,22,16,329,227,102,315,222,93,41,76,10,0,55.15,14.15,1,
2016,New York Giants,Away,Cleveland Browns,27,13,296,192,104,343,285,58,48,58,10,0,55.15,7.15,1,
2016,New York Giants,Away,Pittsburgh Steelers,14,24,234,178,56,389,272,117,43,56,71,0,55.15,12.15,1,
2016,New York Giants,Home,Dallas Cowboys,10,7,260,167,93,260,152,108,32,95,0,0,55.15,23.15,1,
2016,New York Giants,Home,Detroit Lions,17,6,300,186,114,324,268,56,55,100,5,1,55.15,0.15,1,
2016,New York Giants,Away,Philadelphia Eagles,19,24,470,356,114,286,168,118,40,56,10,0,55.15,15.15,1,
2015,New York Giants,Home,Philadelphia Eagles,30,35,502,294,208,435,315,120,45,38,17,0,55.15,10.15,1,
2015,New York Giants,Home,Atlanta Falcons,20,24,388,291,97,402,346,56,73,47,9,0,55.15,17.85,1,
2015,New York Giants,Home,Washington Redskins,32,21,363,279,84,393,305,88,71,60,4,0,55.15,15.85,1,
2015,New York Giants,Away,Buffalo Bills,24,10,303,211,92,313,258,55,60,66,8,0,55.15,4.85,1,
2015,New York Giants,Home,San Francisco 49ers,30,27,525,441,84,380,256,124,61,59,4,0,55.15,5.85,1,
2015,New York Giants,Away,Philadelphia Eagles,7,27,247,166,81,428,270,158,44,49,6,0,55.15,11.15,1,
2015,New York Giants,Home,Dallas Cowboys,27,20,289,157,132,460,227,233,70,41,14,0,55.15,14.85,1,
2015,New York Giants,Away,New Orleans Saints,49,52,416,329,87,608,505,103,65,95,13,1,55.15,9.85,1,
2015,New York Giants,Away,Tampa Bay Buccaneers,32,18,327,213,114,383,247,136,80,90,3,0,55.15,24.85,1,
2015,New York Giants,Home,New England Patriots,26,27,422,342,80,406,329,77,60,31,8,0,55.15,4.85,1,
2015,New York Giants,Away,Washington Redskins,14,20,332,299,33,407,302,105,46,93,5,0,55.15,9.15,1,
2015,New York Giants,Home,New York Jets,20,23,355,281,74,463,373,90,51,50,8,0,55.15,4.15,1,
2015,New York Giants,Away,Miami Dolphins,31,24,429,337,92,363,235,128,77,78,6,0,55.15,21.85,1,
2015,New York Giants,Home,Carolina Panthers,35,38,406,245,161,480,309,171,41,37,8,0,55.15,14.15,1,
2015,New York Giants,Away,Minnesota Vikings,17,49,363,272,91,368,150,218,13,50,8,0,55.15,42.15,1,
2018,New York Jets,Away,Detroit Lions,48,17,349,180,169,339,300,39,68,70,0,0,55.15,12.85,1,
2018,New York Jets,Home,Miami Dolphins,12,20,362,320,42,257,122,135,80,63,4,0,55.15,24.85,1,
2018,New York Jets,Away,Cleveland Browns,17,21,268,161,107,323,190,133,83,64,11,0,55.15,27.85,1,
2018,New York Jets,Away,Jacksonville Jaguars,12,31,178,144,34,503,377,126,86,70,10,0,55.15,30.85,1,
2018,New York Jets,Home,Denver Broncos,34,16,512,189,323,436,344,92,77,79,7,0,55.15,21.85,1,
2018,New York Jets,Home,Indianapolis Colts,42,34,374,267,107,428,301,127,60,53,7,0,55.15,4.85,1,
2018,New York Jets,Home,Minnesota Vikings,17,37,263,192,71,316,228,88,46,48,16,0,55.15,9.15,1,
2018,New York Jets,Away,Chicago Bears,10,24,207,150,57,395,216,179,48,71,18,0,55.15,7.15,1,
2018,New York Jets,Away,Miami Dolphins,6,13,282,202,80,168,104,64,87,62,16,0,55.15,31.85,1,
2018,New York Jets,Home,Buffalo Bills,10,41,199,116,83,451,239,212,46,39,10,0,55.15,9.15,1,
2018,New York Jets,Home,New England Patriots,13,27,338,264,74,498,283,215,54,64,8,0,55.15,1.15,1,
2018,New York Jets,Away,Tennessee Titans,22,26,280,124,156,403,273,130,70,26,13,0,55.15,14.85,1,
2018,New York Jets,Away,Buffalo Bills,27,23,248,170,78,368,192,176,31,63,12,0,55.15,24.15,1,
2018,New York Jets,Home,Houston Texans,22,29,318,228,90,286,239,47,51,85,8,0,55.15,4.15,1,
2018,New York Jets,Home,Green Bay Packers,38,44,370,323,47,540,413,127,43,48,8,0,55.15,12.15,1,
2018,New York Jets,Away,New England Patriots,3,38,239,135,104,375,244,131,33,42,2,0,55.15,22.15,1,
2017,New York Jets,Away,Buffalo Bills,12,21,214,176,38,408,218,190,65,53,5,0,55.15,9.85,1,
2017,New York Jets,Away,Oakland Raiders,20,45,271,145,126,410,230,180,70,57,6,0,55.15,14.85,1,
2017,New York Jets,Home,Miami Dolphins,20,6,336,233,103,225,195,30,88,41,5,0,55.15,32.85,1,
2017,New York Jets,Home,Jacksonville Jaguars,23,20,471,215,256,311,136,175,64,44,5,0,55.15,8.85,1,
2017,New York Jets,Away,Cleveland Browns,17,14,212,178,34,419,279,140,67,71,8,0,55.15,11.85,1,
2017,New York Jets,Home,New England Patriots,17,24,408,334,74,375,257,118,73,70,13,0,55.15,17.85,1,
2017,New York Jets,Away,Miami Dolphins,28,31,272,180,92,357,304,53,86,67,17,0,55.15,30.85,1,
2017,New York Jets,Home,Atlanta Falcons,20,25,279,236,43,386,246,140,63,93,5,1,55.15,7.85,1,
2017,New York Jets,Home,Buffalo Bills,34,21,331,137,194,307,244,63,68,70,11,0,55.15,12.85,1,
2017,New York Jets,Away,Tampa Bay Buccaneers,10,15,275,219,56,271,181,90,79,69,16,0,55.15,23.85,1,
2017,New York Jets,Home,Carolina Panthers,27,35,391,282,109,299,154,145,47,42,18,0,55.15,8.15,1,
2017,New York Jets,Home,Kansas City Chiefs,38,31,488,331,157,474,362,112,48,64,0,0,55.15,7.15,1,
2017,New York Jets,Away,Denver Broncos,0,23,100,41,59,273,189,84,60,8,3,0,55.15,4.85,1,
2017,New York Jets,Away,New Orleans Saints,19,31,294,170,124,412,281,131,67,97,4,1,55.15,11.85,1,
2017,New York Jets,Home,Los Angeles Chargers,7,14,295,98,197,379,290,89,40,55,6,0,55.15,15.15,1,
2017,New York Jets,Away,New England Patriots,6,26,247,207,40,330,183,147,13,42,14,0,55.15,42.15,1,
2016,New York Jets,Home,Buffalo Bills,30,10,329,202,127,230,162,68,42,38,11,0,55.15,13.15,1,
2016,New York Jets,Home,Cincinnati Bengals,22,23,340,188,152,381,324,57,79,40,20,0,55.15,23.85,1,
2016,New York Jets,Away,Buffalo Bills,37,31,493,370,123,393,307,86,60,65,11,0,55.15,4.85,1,
2016,New York Jets,Away,Kansas City Chiefs,3,24,305,188,117,293,221,72,65,63,9,0,55.15,9.85,1,
2016,New York Jets,Home,Seattle Seahawks,17,27,305,247,58,354,288,66,61,77,0,0,55.15,5.85,1,
2016,New York Jets,Away,Pittsburgh Steelers,13,31,316,244,72,436,375,61,57,60,9,0,55.15,1.85,1,
2016,New York Jets,Home,Baltimore Ravens,24,16,344,189,155,245,234,11,58,38,36,0,55.15,2.85,1,
2016,New York Jets,Away,Cleveland Browns,31,28,393,222,171,407,339,68,53,91,15,1,55.15,2.15,1,
2016,New York Jets,Away,Miami Dolphins,23,27,331,191,140,274,137,137,80,58,14,0,55.15,24.85,1,
2016,New York Jets,Home,Los Angeles Rams,6,9,296,157,139,280,155,125,62,18,7,0,55.15,6.85,1,
2016,New York Jets,Home,New England Patriots,17,22,333,269,64,377,286,91,47,43,10,0,55.15,8.15,1,
2016,New York Jets,Home,Indianapolis Colts,10,41,250,214,36,421,282,139,45,60,6,0,55.15,10.15,1,
2016,New York Jets,Away,San Francisco 49ers,23,17,404,216,188,364,116,248,54,62,8,0,55.15,1.15,1,
2016,New York Jets,Home,Miami Dolphins,13,34,360,244,116,303,236,67,32,92,5,0,55.15,23.15,1,
2016,New York Jets,Away,New England Patriots,3,41,239,128,111,325,211,114,40,95,6,1,55.15,15.15,1,
2015,New York Jets,Away,Buffalo Bills,17,22,300,178,122,295,182,113,35,70,21,0,55.15,20.15,1,
2015,New York Jets,Home,Cleveland Browns,31,10,333,179,154,321,217,104,77,49,8,0,55.15,21.85,1,
2015,New York Jets,Away,Indianapolis Colts,20,7,344,243,101,343,250,93,69,41,7,0,55.15,13.85,1,
2015,New York Jets,Home,Philadelphia Eagles,17,24,323,276,47,231,108,123,66,52,7,0,55.15,10.85,1,
2015,New York Jets,Away,Miami Dolphins,27,14,425,218,207,226,167,59,59,63,5,0,55.15,3.85,1,
2015,New York Jets,Home,Washington Redskins,34,20,474,253,221,225,191,34,49,30,16,0,55.15,6.15,1,
2015,New York Jets,Away,New England Patriots,23,30,372,283,89,353,337,16,58,80,9,0,55.15,2.85,1,
2015,New York Jets,Away,Oakland Raiders,20,34,366,292,74,451,333,118,68,70,8,0,55.15,12.85,1,
2015,New York Jets,Home,Jacksonville Jaguars,28,23,290,261,29,436,338,98,56,36,10,0,55.15,0.85,1,
2015,New York Jets,Home,Buffalo Bills,17,22,318,190,128,280,132,148,60,75,16,0,55.15,4.85,1,
2015,New York Jets,Away,Houston Texans,17,24,267,197,70,364,241,123,52,39,11,0,55.15,3.15,1,
2015,New York Jets,Home,Miami Dolphins,38,20,411,274,137,333,321,12,45,44,5,0,55.15,10.15,1,
2015,New York Jets,Away,New York Giants,23,20,463,373,90,355,281,74,51,50,8,0,55.15,4.15,1,
2015,New York Jets,Home,Tennessee Titans,30,8,439,256,183,292,268,24,67,56,5,0,55.15,11.85,1,
2015,New York Jets,Away,Dallas Cowboys,19,16,372,299,73,309,176,133,61,39,9,0,55.15,5.85,1,
2015,New York Jets,Home,New England Patriots,26,20,428,285,143,284,221,63,57,83,15,0,55.15,1.85,1,
2018,Oakland Raiders,Home,Los Angeles Rams,13,33,395,300,95,365,225,140,69,58,10,0,59.2,9.8,1,
2018,Oakland Raiders,Away,Denver Broncos,19,20,373,281,92,385,217,168,92,13,4,0,59.2,32.8,1,
2018,Oakland Raiders,Away,Miami Dolphins,20,28,434,325,109,373,332,41,90,58,7,0,59.2,30.8,1,
2018,Oakland Raiders,Home,Cleveland Browns,45,42,565,426,139,487,279,208,71,58,8,0,59.2,11.8,1,
2018,Oakland Raiders,Away,Los Angeles Chargers,10,26,289,248,41,412,333,79,75,60,10,0,59.2,15.8,1,
2018,Oakland Raiders,Home,Seattle Seahawks,3,27,185,106,79,369,214,155,52,93,10,0,59.2,7.2,1,
2018,Oakland Raiders,Home,Indianapolis Colts,28,42,347,244,103,461,239,222,69,67,8,0,59.2,9.8,1,
2018,Oakland Raiders,Away,San Francisco 49ers,3,34,242,140,102,405,262,143,82,28,8,0,59.2,22.8,1,
2018,Oakland Raiders,Home,Los Angeles Chargers,6,20,317,203,114,335,222,113,69,15,16,0,59.2,9.8,1,
2018,Oakland Raiders,Away,Arizona Cardinals,23,21,325,173,152,282,128,154,72,20,3,0,59.2,12.8,1,
2018,Oakland Raiders,Away,Baltimore Ravens,17,34,249,182,67,416,174,242,60,54,7,0,59.2,0.8,1,
2018,Oakland Raiders,Home,Kansas City Chiefs,33,40,442,271,171,469,295,174,57,52,6,0,59.2,2.2,1,
2018,Oakland Raiders,Home,Pittsburgh Steelers,24,21,354,299,55,340,300,40,55,74,8,0,59.2,4.2,1,
2018,Oakland Raiders,Away,Cincinnati Bengals,16,30,297,229,68,294,123,171,43,96,2,0,59.2,16.2,1,
2018,Oakland Raiders,Home,Denver Broncos,27,14,273,159,114,300,200,100,58,80,14,1,59.2,1.2,1,
2018,Oakland Raiders,Away,Kansas City Chiefs,3,35,292,165,127,409,310,99,45,43,15,0,59.2,14.2,1,
2017,Oakland Raiders,Away,Tennessee Titans,26,16,359,250,109,350,255,95,72,50,7,0,59.2,12.8,1,
2017,Oakland Raiders,Home,New York Jets,45,20,410,230,180,271,145,126,70,57,6,0,59.2,10.8,1,
2017,Oakland Raiders,Away,Washington Redskins,10,27,128,96,32,472,356,116,76,75,0,0,59.2,16.8,1,
2017,Oakland Raiders,Away,Denver Broncos,10,16,254,230,24,298,155,143,72,26,7,0,59.2,12.8,1,
2017,Oakland Raiders,Home,Baltimore Ravens,17,30,245,137,108,365,222,143,72,42,8,0,59.2,12.8,1,
2017,Oakland Raiders,Home,Los Angeles Chargers,16,17,274,165,109,343,263,80,76,25,9,0,59.2,16.8,1,
2017,Oakland Raiders,Home,Kansas City Chiefs,31,30,505,417,88,425,331,94,62,78,1,0,59.2,2.8,1,
2017,Oakland Raiders,Away,Buffalo Bills,14,34,367,313,54,331,165,166,42,94,7,1,59.2,17.2,1,
2017,Oakland Raiders,Away,Miami Dolphins,27,24,379,295,84,395,309,86,77,82,2,0,59.2,17.8,1,
2017,Oakland Raiders,Home,New England Patriots,8,33,344,235,109,421,332,89,66,42,0,0,59.2,6.8,1,
2017,Oakland Raiders,Home,Denver Broncos,21,14,348,244,104,216,160,56,61,95,13,0,59.2,1.8,1,
2017,Oakland Raiders,Home,New York Giants,24,17,401,282,119,265,200,65,58,51,11,0,59.2,1.2,1,
2017,Oakland Raiders,Away,Kansas City Chiefs,15,26,268,198,70,408,243,165,68,70,0,0,59.2,8.8,1,
2017,Oakland Raiders,Home,Dallas Cowboys,17,20,293,171,122,330,204,126,57,37,4,0,59.2,2.2,1,
2017,Oakland Raiders,Away,Philadelphia Eagles,10,19,274,137,137,216,138,78,29,37,15,0,59.2,30.2,1,
2017,Oakland Raiders,Away,Los Angeles Chargers,10,30,336,231,105,495,380,115,62,70,2,0,59.2,2.8,1,
2016,Oakland Raiders,Away,Denver Broncos,6,24,221,164,57,349,206,143,40,95,6,0,59.2,19.2,1,
2016,Oakland Raiders,Away,New Orleans Saints,35,34,486,319,167,507,419,88,87,69,4,0,59.2,27.8,1,
2016,Oakland Raiders,Home,Atlanta Falcons,28,35,454,299,155,528,389,139,79,41,7,0,59.2,19.8,1,
2016,Oakland Raiders,Away,Tennessee Titans,17,10,368,245,123,393,212,181,89,49,2,0,59.2,29.8,1,
2016,Oakland Raiders,Away,Baltimore Ravens,28,27,261,199,62,412,282,130,65,84,2,0,59.2,5.8,1,
2016,Oakland Raiders,Home,San Diego Chargers,34,31,389,300,89,423,351,72,75,39,7,0,59.2,15.8,1,
2016,Oakland Raiders,Home,Kansas City Chiefs,10,26,285,221,64,406,223,183,61,100,6,1,59.2,1.8,1,
2016,Oakland Raiders,Away,Jacksonville Jaguars,33,16,344,200,144,344,239,105,70,47,6,0,59.2,10.8,1,
2016,Oakland Raiders,Away,Tampa Bay Buccaneers,30,24,626,498,128,270,168,102,86,54,18,0,59.2,26.8,1,
2016,Oakland Raiders,Home,Denver Broncos,30,20,397,179,218,299,266,33,65,79,6,0,59.2,5.8,1,
2016,Oakland Raiders,Home,Houston Texans,27,20,325,295,30,354,230,124,63,39,6,0,59.2,3.8,1,
2016,Oakland Raiders,Home,Carolina Panthers,35,32,366,310,56,358,229,129,59,55,12,0,59.2,0.2,1,
2016,Oakland Raiders,Home,Buffalo Bills,38,24,399,260,139,382,170,212,59,70,4,0,59.2,0.2,1,
2016,Oakland Raiders,Away,Kansas City Chiefs,13,21,244,109,135,323,258,65,21,57,7,0,59.2,38.2,1,
2016,Oakland Raiders,Away,San Diego Chargers,19,16,345,200,145,263,190,73,62,22,5,0,59.2,2.8,1,
2016,Oakland Raiders,Home,Indianapolis Colts,33,25,463,253,210,390,288,102,50,61,9,0,59.2,9.2,1,
2015,Oakland Raiders,Away,Kansas City Chiefs,17,23,205,157,48,339,150,189,37,56,9,0,59.2,22.2,1,
2015,Oakland Raiders,Home,Cincinnati Bengals,13,33,246,183,63,396,269,127,73,59,9,0,59.2,13.8,1,
2015,Oakland Raiders,Home,Baltimore Ravens,37,33,448,351,97,493,384,109,80,32,8,0,59.2,20.8,1,
2015,Oakland Raiders,Away,Cleveland Browns,27,20,469,314,155,355,316,39,75,62,15,0,59.2,15.8,1,
2015,Oakland Raiders,Away,Chicago Bears,20,22,243,173,70,371,273,98,55,83,12,0,59.2,4.2,1,
2015,Oakland Raiders,Home,Denver Broncos,10,16,288,223,65,297,254,43,72,59,10,0,59.2,12.8,1,
2015,Oakland Raiders,Away,San Diego Chargers,37,29,412,282,130,417,327,90,77,48,4,0,59.2,17.8,1,
2015,Oakland Raiders,Home,New York Jets,34,20,451,333,118,366,292,74,68,70,8,0,59.2,8.8,1,
2015,Oakland Raiders,Away,Pittsburgh Steelers,35,38,440,301,139,597,402,195,54,38,5,0,59.2,5.2,1,
2015,Oakland Raiders,Home,Minnesota Vikings,14,30,371,287,84,385,122,263,62,50,31,0,59.2,2.8,1,
2015,Oakland Raiders,Away,Detroit Lions,13,18,216,164,52,375,266,109,68,70,0,0,59.2,8.8,1,
2015,Oakland Raiders,Away,Tennessee Titans,24,21,407,323,84,249,205,44,56,100,4,1,59.2,3.2,1,
2015,Oakland Raiders,Home,Kansas City Chiefs,20,34,361,262,99,232,143,89,57,95,3,0,59.2,2.2,1,
2015,Oakland Raiders,Away,Denver Broncos,15,12,126,99,27,310,276,34,45,33,2,0,59.2,14.2,1,
2015,Oakland Raiders,Home,Green Bay Packers,20,30,372,252,120,293,190,103,54,70,18,0,59.2,5.2,1,
2015,Oakland Raiders,Home,San Diego Chargers,23,20,281,175,106,343,271,72,47,70,25,0,59.2,12.2,1,
2018,Philidelphia Eagles,Home,Atlanta Falcons,18,12,232,119,113,299,225,74,81,71,8,0,55.85,25.15,1,
2018,Philidelphia Eagles,Away,Tampa Bay Buccaneers,21,27,412,321,91,436,393,43,91,65,9,0,55.85,35.15,1,
2018,Philidelphia Eagles,Home,Indianapolis Colts,20,16,379,227,152,209,141,68,61,92,5,1,55.85,5.15,1,
2018,Philidelphia Eagles,Away,Tennessee Titans,23,26,432,315,117,397,327,70,80,56,4,0,55.85,24.15,1,
2018,Philidelphia Eagles,Home,Minnesota Vikings,21,23,364,283,81,375,298,77,79,77,6,0,55.85,23.15,1,
2018,Philidelphia Eagles,Away,New York Giants,34,13,379,271,108,401,254,147,70,98,3,0,55.85,14.15,1,
2018,Philidelphia Eagles,Home,Carolina Panthers,17,21,342,284,58,371,250,121,49,41,19,0,55.85,6.85,1,
2018,Philidelphia Eagles,Away,Jacksonville Jaguars,24,18,395,262,133,335,265,70,48,59,12,0,55.85,7.85,1,
2018,Philidelphia Eagles,Home,Dallas Cowboys,20,27,421,350,71,410,239,171,38,62,5,0,55.85,17.85,1,
2018,Philidelphia Eagles,Away,New Orleans Saints,7,48,196,138,58,546,373,173,68,54,4,0,55.85,12.15,1,
2018,Philidelphia Eagles,Home,New York Giants,25,22,341,214,127,402,276,126,56,58,10,0,55.85,0.15,1,
2018,Philidelphia Eagles,Home,Washington Redskins,28,13,436,306,130,235,131,104,36,58,15,0,55.85,19.85,1,
2018,Philidelphia Eagles,Away,Dallas Cowboys,23,29,256,222,34,576,434,142,51,55,10,0,55.85,4.85,1,
2018,Philidelphia Eagles,Away,Los Angeles Rams,30,23,381,270,111,407,325,82,60,79,5,0,55.85,4.15,1,
2018,Philidelphia Eagles,Home,Houston Texans,32,30,519,462,57,371,309,62,44,44,5,0,55.85,11.85,1,
2018,Philidelphia Eagles,Away,Washington Redskins,24,0,360,231,129,89,68,21,46,62,3,0,55.85,9.85,1,
2017,Philidelphia Eagles,Away,Washington Redskins,30,17,356,298,58,264,200,64,67,54,5,0,55.85,11.15,1,
2017,Philidelphia Eagles,Away,Kansas City Chiefs,20,27,406,299,107,344,232,112,68,95,7,0,55.85,12.15,1,
2017,Philidelphia Eagles,Home,New York Giants,27,24,354,161,193,415,366,49,89,48,6,0,55.85,33.15,1,
2017,Philidelphia Eagles,Away,Los Angeles Chargers,26,24,454,240,214,400,342,58,72,70,6,0,55.85,16.15,1,
2017,Philidelphia Eagles,Home,Arizona Cardinals,34,7,419,297,122,307,276,31,77,91,10,1,55.85,21.15,1,
2017,Philidelphia Eagles,Away,Carolina Panthers,28,23,310,209,101,305,225,80,72,88,6,0,55.85,16.15,1,
2017,Philidelphia Eagles,Home,Washington Redskins,34,24,371,244,127,344,269,75,70,78,9,0,55.85,14.15,1,
2017,Philidelphia Eagles,Home,San Francisco 49ers,33,10,304,192,112,238,144,94,67,91,12,1,55.85,11.15,1,
2017,Philidelphia Eagles,Home,Denver Broncos,51,23,419,222,197,226,191,35,61,89,5,0,55.85,5.15,1,
2017,Philidelphia Eagles,Away,Dallas Cowboys,37,9,383,168,215,225,113,112,54,36,0,0,55.85,1.85,1,
2017,Philidelphia Eagles,Home,Chicago Bears,31,3,420,244,176,140,134,6,49,42,17,0,55.85,6.85,1,
2017,Philidelphia Eagles,Away,Seattle Seahawks,10,24,425,327,98,310,209,101,44,78,3,0,55.85,11.85,1,
2017,Philidelphia Eagles,Away,Los Angeles Rams,43,35,455,316,139,307,198,109,83,8,0,0,55.85,27.15,1,
2017,Philidelphia Eagles,Away,New York Giants,34,29,341,233,108,504,429,75,35,58,5,0,55.85,20.85,1,
2017,Philidelphia Eagles,Home,Oakland Raiders,19,10,216,138,78,274,137,137,29,37,15,0,55.85,26.85,1,
2017,Philidelphia Eagles,Home,Dallas Cowboys,0,6,219,149,70,301,172,129,19,30,17,0,55.85,36.85,1,
2016,Philidelphia Eagles,Home,Dallas Cowboys,27,13,346,232,114,195,126,69,50,38,10,0,55.85,5.85,1,
2016,Philidelphia Eagles,Home,Cleveland Browns,29,10,403,270,133,288,168,120,85,42,14,0,55.85,29.15,1,
2016,Philidelphia Eagles,Away,Chicago Bears,29,14,280,180,100,284,220,64,84,36,5,0,55.85,28.15,1,
2016,Philidelphia Eagles,Home,Pittsburgh Steelers,34,3,426,301,125,251,222,29,73,39,7,0,55.85,17.15,1,
2016,Philidelphia Eagles,Away,Detroit Lions,23,24,346,230,116,244,164,80,68,70,0,0,55.85,12.15,1,
2016,Philidelphia Eagles,Away,Washington Redskins,20,27,239,145,94,493,263,230,69,62,13,0,55.85,13.15,1,
2016,Philidelphia Eagles,Home,Minnesota Vikings,21,10,239,138,101,282,189,93,62,46,20,0,55.85,6.15,1,
2016,Philidelphia Eagles,Away,Dallas Cowboys,23,29,291,194,97,460,273,187,84,44,5,0,55.85,28.15,1,
2016,Philidelphia Eagles,Away,New York Giants,23,28,443,347,96,302,248,54,56,41,9,0,55.85,0.15,1,
2016,Philidelphia Eagles,Home,Atlanta Falcons,24,15,429,221,208,303,255,48,58,37,10,0,55.85,2.15,1,
2016,Philidelphia Eagles,Away,Seattle Seahawks,15,26,308,195,113,439,287,152,54,80,5,1,55.85,1.85,1,
2016,Philidelphia Eagles,Home,Green Bay Packers,13,27,292,211,81,387,313,74,47,65,7,0,55.85,8.85,1,
2016,Philidelphia Eagles,Away,Cincinnati Bengals,14,32,359,306,53,412,332,80,42,61,10,0,55.85,13.85,1,
2016,Philidelphia Eagles,Home,Washington Redskins,22,27,383,288,95,334,227,107,35,50,3,0,55.85,20.85,1,
2016,Philidelphia Eagles,Away,Baltimore Ravens,26,27,328,159,169,340,189,151,62,77,9,0,55.85,6.15,1,
2016,Philidelphia Eagles,Home,New York Giants,24,19,286,168,118,470,356,114,40,56,10,0,55.85,15.85,1,
2015,Philidelphia Eagles,Away,New York Giants,35,30,435,315,120,502,294,208,45,38,17,0,55.85,10.85,1,
2015,Philidelphia Eagles,Away,Atlanta Falcons,24,26,399,336,63,395,290,105,68,70,0,0,55.85,12.15,0,
2015,Philidelphia Eagles,Home,Dallas Cowboys,10,20,226,219,7,359,250,109,77,37,15,0,55.85,21.15,1,
2015,Philidelphia Eagles,Away,New York Jets,24,17,231,108,123,323,276,47,66,52,7,0,55.85,10.15,1,
2015,Philidelphia Eagles,Away,Washington Redskins,20,23,320,233,87,417,290,127,58,82,13,0,55.85,2.15,1,
2015,Philidelphia Eagles,Home,New Orleans Saints,39,17,519,333,186,388,292,96,67,54,6,0,55.85,11.15,1,
2015,Philidelphia Eagles,Home,New York Giants,27,7,428,270,158,247,166,81,44,49,6,0,55.85,11.85,1,
2015,Philidelphia Eagles,Away,Carolina Panthers,16,27,349,172,177,394,190,204,71,80,0,0,55.85,15.15,1,
2015,Philidelphia Eagles,Away,Dallas Cowboys,33,27,459,287,172,411,277,134,60,43,5,0,55.85,4.15,1,
2015,Philidelphia Eagles,Home,Miami Dolphins,19,20,436,353,83,289,190,99,59,34,13,0,55.85,3.15,1,
2015,Philidelphia Eagles,Home,Tampa Bay Buccaneers,17,45,383,247,136,521,238,283,48,41,15,0,55.85,7.85,1,
2015,Philidelphia Eagles,Away,Detroit Lions,14,45,227,159,68,430,322,108,68,70,0,0,55.85,12.15,1,
2015,Philidelphia Eagles,Away,New England Patriots,35,28,248,120,128,427,324,103,52,49,5,0,55.85,3.85,1,
2015,Philidelphia Eagles,Home,Buffalo Bills,23,20,348,232,116,412,260,152,66,68,3,0,55.85,10.15,1,
2015,Philidelphia Eagles,Home,Arizona Cardinals,17,40,424,350,74,493,263,230,37,54,4,0,55.85,18.85,1,
2015,Philidelphia Eagles,Home,Washington Redskins,24,38,398,353,45,418,351,67,52,72,6,0,55.85,3.85,1,
2018,Pittsburgh Steelers,Away,Cleveland Browns,21,21,472,313,159,327,150,177,58,84,11,1,52,6,1,
2018,Pittsburgh Steelers,Home,Kansas City Chiefs,37,42,475,442,33,449,322,127,80,65,10,0,52,28,1,
2018,Pittsburgh Steelers,Away,Tampa Bay Buccaneers,30,27,413,335,78,455,392,63,77,89,5,0,52,25,1,
2018,Pittsburgh Steelers,Home,Baltimore Ravens,14,26,284,265,19,451,355,96,69,86,2,0,52,17,1,
2018,Pittsburgh Steelers,Home,Atlanta Falcons,41,17,381,250,131,324,262,62,83,69,5,0,52,31,1,
2018,Pittsburgh Steelers,Away,Cincinnati Bengals,28,21,481,369,112,275,213,62,51,93,6,0,52,1,1,
2018,Pittsburgh Steelers,Home,Cleveland Browns,33,18,421,253,168,237,163,74,47,79,11,0,52,5,1,
2018,Pittsburgh Steelers,Away,Baltimore Ravens,23,16,395,282,113,265,204,61,55,45,6,0,52,3,1,
2018,Pittsburgh Steelers,Home,Carolina Panthers,52,21,457,319,138,242,147,95,40,76,4,0,52,12,1,
2018,Pittsburgh Steelers,Away,Jacksonville Jaguars,20,16,323,297,26,243,64,179,73,60,8,0,52,21,1,
2018,Pittsburgh Steelers,Away,Denver Broncos,17,24,527,452,75,308,184,124,41,26,7,0,52,11,1,
2018,Pittsburgh Steelers,Home,Los Angeles Chargers,30,33,336,271,65,371,286,85,57,55,8,0,52,5,1,
2018,Pittsburgh Steelers,Away,Oakland Raiders,21,24,340,300,40,354,299,55,55,74,8,0,52,3,1,
2018,Pittsburgh Steelers,Home,New England Patriots,17,10,376,218,158,368,272,96,42,90,5,0,52,10,1,
2018,Pittsburgh Steelers,Away,New Orleans Saints,28,31,429,364,65,370,313,57,68,71,10,0,52,16,1,
2018,Pittsburgh Steelers,Home,Cincinnati Bengals,16,13,343,278,65,196,71,125,42,63,9,0,52,10,1,
2017,Pittsburgh Steelers,Away,Cleveland Browns,21,18,290,255,35,237,180,57,63,53,12,0,52,11,1,
2017,Pittsburgh Steelers,Home,Minnesota Vikings,26,9,335,233,102,237,146,91,78,64,1,0,52,26,1,
2017,Pittsburgh Steelers,Away,Chicago Bears,17,23,282,212,70,306,84,222,89,48,5,0,52,37,1,
2017,Pittsburgh Steelers,Away,Baltimore Ravens,26,9,381,208,173,288,206,82,64,52,6,0,52,12,1,
2017,Pittsburgh Steelers,Home,Jacksonville Jaguars,9,30,371,301,70,313,82,231,73,80,9,0,52,21,1,
2017,Pittsburgh Steelers,Away,Kansas City Chiefs,19,13,439,245,194,251,223,28,60,56,14,0,52,8,1,
2017,Pittsburgh Steelers,Home,Cincinnati Bengals,29,14,420,268,152,179,108,71,79,37,6,0,52,27,1,
2017,Pittsburgh Steelers,Away,Detroit Lions,20,15,392,317,75,482,411,71,68,70,0,0,52,16,1,
2017,Pittsburgh Steelers,Away,Indianapolis Colts,20,17,316,228,88,267,196,71,42,70,5,0,52,10,1,
2017,Pittsburgh Steelers,Home,Tennessee Titans,40,17,349,284,65,316,264,52,40,67,14,0,52,12,1,
2017,Pittsburgh Steelers,Home,Green Bay Packers,31,28,462,341,121,307,227,80,38,47,7,0,52,14,1,
2017,Pittsburgh Steelers,Away,Cincinnati Bengals,23,20,374,282,92,353,223,130,61,44,9,1,52,9,1,
2017,Pittsburgh Steelers,Home,Baltimore Ravens,39,38,545,486,59,413,261,152,33,55,12,0,52,19,1,
2017,Pittsburgh Steelers,Home,New England Patriots,24,27,413,270,143,360,283,77,42,62,4,0,52,10,1,
2017,Pittsburgh Steelers,Away,Houston Texans,34,6,330,226,104,227,51,176,51,56,8,0,52,1,1,
2017,Pittsburgh Steelers,Home,Cleveland Browns,28,24,348,224,124,374,272,102,11,80,3,1,52,41,1,
2016,Pittsburgh Steelers,Home,Cleveland Browns,27,24,312,243,69,437,206,231,41,64,1,0,52,11,1,
2016,Pittsburgh Steelers,Away,Washington Redskins,38,16,437,290,147,384,329,55,79,41,4,0,52,27,1,
2016,Pittsburgh Steelers,Home,Cincinnati Bengals,24,16,374,250,124,412,366,46,72,86,4,0,52,20,1,
2016,Pittsburgh Steelers,Away,Philadelphia Eagles,3,34,251,222,29,426,301,125,73,39,7,0,52,21,1,
2016,Pittsburgh Steelers,Home,Kansas City Chiefs,43,14,436,287,149,357,270,87,59,80,6,1,52,7,1,
2016,Pittsburgh Steelers,Home,New York Jets,31,13,436,375,61,316,244,72,57,60,9,0,52,5,1,
2016,Pittsburgh Steelers,Away,Miami Dolphins,15,30,297,169,128,474,252,222,81,79,15,0,52,29,1,
2016,Pittsburgh Steelers,Home,New England Patriots,16,27,375,281,94,362,222,140,64,53,14,0,52,12,1,
2016,Pittsburgh Steelers,Away,Baltimore Ravens,14,21,277,241,36,274,224,50,65,28,15,0,52,13,1,
2016,Pittsburgh Steelers,Home,Dallas Cowboys,30,35,448,400,48,422,295,127,56,29,7,0,52,4,1,
2016,Pittsburgh Steelers,Away,Cleveland Browns,24,9,313,167,146,209,176,33,36,64,27,0,52,16,1,
2016,Pittsburgh Steelers,Away,Indianapolis Colts,28,7,369,221,148,310,219,91,39,85,9,0,52,13,1,
2016,Pittsburgh Steelers,Home,New York Giants,24,14,389,272,117,234,178,56,43,56,71,0,52,9,1,
2016,Pittsburgh Steelers,Away,Buffalo Bills,27,20,460,220,240,275,208,67,27,75,9,1,52,25,1,
2016,Pittsburgh Steelers,Away,Cincinnati Bengals,24,20,382,285,97,222,146,76,24,86,8,0,52,28,1,
2016,Pittsburgh Steelers,Home,Baltimore Ravens,31,27,406,279,127,368,246,122,41,73,9,0,52,11,1,
2015,Pittsburgh Steelers,Away,Cleveland Browns,28,12,379,349,30,263,177,86,34,75,18,0,52,18,1,
2015,Pittsburgh Steelers,Away,New England Patriots,21,28,464,330,134,361,281,80,65,100,7,1,52,13,1,
2015,Pittsburgh Steelers,Home,San Francisco 49ers,43,18,453,369,84,409,298,111,66,60,10,0,52,14,1,
2015,Pittsburgh Steelers,Home,Baltimore Ravens,20,23,263,96,167,356,165,191,63,62,8,0,52,11,1,
2015,Pittsburgh Steelers,Away,San Diego Chargers,24,20,349,194,155,406,354,52,93,32,10,0,52,41,1,
2015,Pittsburgh Steelers,Home,Arizona Cardinals,25,13,310,169,141,469,414,55,45,47,12,0,52,7,1,
2015,Pittsburgh Steelers,Away,Kansas City Chiefs,13,23,339,192,147,377,239,138,58,57,7,0,52,6,1,
2015,Pittsburgh Steelers,Home,Cincinnati Bengals,10,16,356,240,116,296,218,78,62,71,11,0,52,10,1,
2015,Pittsburgh Steelers,Home,Oakland Raiders,38,35,597,402,195,440,301,139,54,38,5,0,52,2,1,
2015,Pittsburgh Steelers,Home,Cleveland Browns,30,9,459,399,60,342,327,15,61,32,12,0,52,9,1,
2015,Pittsburgh Steelers,Away,Seattle Seahawks,30,39,538,480,58,436,336,100,38,80,2,0,52,14,1,
2015,Pittsburgh Steelers,Home,Indianapolis Colts,45,10,522,364,158,240,186,54,37,74,2,0,52,15,1,
2015,Pittsburgh Steelers,Away,Cincinnati Bengals,33,20,354,270,84,385,321,64,63,79,8,0,52,11,1,
2015,Pittsburgh Steelers,Home,Denver Broncos,34,27,377,354,23,385,281,104,41,35,8,0,52,11,1,
2015,Pittsburgh Steelers,Away,Baltimore Ravens,17,20,308,198,110,386,265,121,64,87,9,0,52,12,1,
2018,San Francisco 49ers,Away,Minnesota Vikings,16,24,327,237,90,343,227,116,68,70,0,0,57.3,10.7,0,
2018,San Francisco 49ers,Home,Detroit Lions,30,27,346,156,190,427,329,98,73,12,0,0,57.3,15.7,1,
2018,San Francisco 49ers,Away,Kansas City Chiefs,27,38,406,228,178,384,307,77,70,64,4,0,57.3,12.7,1,
2018,San Francisco 49ers,Away,Los Angeles Chargers,27,29,364,288,76,368,242,126,78,56,9,0,57.3,20.7,1,
2018,San Francisco 49ers,Home,Arizona Cardinals,18,28,447,300,147,220,164,56,79,19,15,0,57.3,21.7,1,
2018,San Francisco 49ers,Away,Green Bay Packers,30,33,401,227,174,521,405,116,37,55,5,0,57.3,20.3,1,
2018,San Francisco 49ers,Home,Los Angeles Rams,10,39,228,121,107,339,193,146,62,69,5,0,57.3,4.7,1,
2018,San Francisco 49ers,Away,Arizona Cardinals,15,18,267,160,107,321,233,88,68,70,0,0,57.3,10.7,0,
2018,San Francisco 49ers,Home,Oakland Raiders,34,3,405,262,143,242,140,102,82,28,8,0,57.3,24.7,1,
2018,San Francisco 49ers,Home,New York Giants,23,27,374,250,124,277,180,97,62,22,0,0,57.3,4.7,1,
2018,San Francisco 49ers,Away,Tampa Bay Buccaneers,9,27,342,194,148,412,304,108,77,62,7,0,57.3,19.7,1,
2018,San Francisco 49ers,Away,Seattle Seahawks,16,43,452,386,66,331,163,168,45,81,2,0,57.3,12.3,1,
2018,San Francisco 49ers,Home,Denver Broncos,20,14,389,305,84,274,171,103,54,72,3,0,57.3,3.3,1,
2018,San Francisco 49ers,Home,Seattle Seahawks,26,23,351,257,94,385,217,168,61,68,11,0,57.3,3.7,1,
2018,San Francisco 49ers,Home,Chicago Bears,9,14,279,232,47,325,235,90,50,76,5,0,57.3,7.3,1,
2018,San Francisco 49ers,Away,Los Angeles Rams,32,48,391,264,127,377,222,155,65,30,3,0,57.3,7.7,1,
2017,San Francisco 49ers,Home,Carolina Panthers,3,23,217,166,51,287,171,116,87,43,8,0,57.3,29.7,1,
2017,San Francisco 49ers,Away,Seattle Seahawks,9,12,248,89,159,312,181,131,65,60,12,0,57.3,7.7,1,
2017,San Francisco 49ers,Home,Los Angeles Rams,39,41,421,308,113,418,292,126,68,42,13,0,57.3,10.7,1,
2017,San Francisco 49ers,Away,Arizona Cardinals,15,18,305,210,95,368,317,51,68,70,0,0,57.3,10.7,0,
2017,San Francisco 49ers,Away,Indianapolis Colts,23,26,402,336,66,447,288,159,68,60,12,0,57.3,10.7,1,
2017,San Francisco 49ers,Away,Washington Redskins,24,26,335,250,85,419,325,94,68,85,4,0,57.3,10.7,1,
2017,San Francisco 49ers,Home,Dallas Cowboys,10,40,290,187,103,501,236,265,68,60,10,0,57.3,10.7,1,
2017,San Francisco 49ers,Away,Philadelphia Eagles,10,33,238,144,94,304,192,112,67,91,12,1,57.3,9.7,1,
2017,San Francisco 49ers,Home,Arizona Cardinals,10,20,329,266,63,368,201,167,61,48,8,0,57.3,3.7,1,
2017,San Francisco 49ers,Home,New York Giants,31,21,474,288,186,374,260,114,68,46,5,0,57.3,10.7,1,
2017,San Francisco 49ers,Home,Seattle Seahawks,13,24,280,196,84,318,228,90,66,68,12,0,57.3,8.7,1,
2017,San Francisco 49ers,Away,Chicago Bears,15,14,388,278,110,147,85,62,54,44,6,0,57.3,3.3,1,
2017,San Francisco 49ers,Home,Tennessee Titans,25,23,414,363,51,328,238,90,65,17,17,0,57.3,7.7,1,
2017,San Francisco 49ers,Home,Jacksonville Jaguars,44,33,369,238,131,472,380,92,52,64,1,0,57.3,5.3,1,
2017,San Francisco 49ers,Away,Los Angeles Rams,34,13,461,292,169,251,149,102,67,43,3,0,57.3,9.7,1,
2016,San Francisco 49ers,Home,Seattle Seahawks,23,25,253,191,62,376,289,87,54,60,5,0,57.3,3.3,1,
2016,San Francisco 49ers,Home,Los Angeles Rams,28,0,320,170,150,185,120,65,66,56,17,0,57.3,8.7,1,
2016,San Francisco 49ers,Away,Carolina Panthers,27,46,302,237,65,529,353,176,82,60,4,0,57.3,24.7,1,
2016,San Francisco 49ers,Away,Seattle Seahawks,18,37,254,119,135,418,291,127,66,63,6,0,57.3,8.7,1,
2016,San Francisco 49ers,Home,Dallas Cowboys,17,24,295,189,106,428,234,194,68,60,10,0,57.3,10.7,1,
2016,San Francisco 49ers,Home,Arizona Cardinals,21,33,286,135,151,288,116,172,75,34,16,0,57.3,17.7,1,
2016,San Francisco 49ers,Away,Buffalo Bills,16,45,300,167,133,492,179,313,71,62,22,0,57.3,13.7,1,
2016,San Francisco 49ers,Home,Tampa Bay Buccaneers,17,34,273,113,160,513,264,249,68,49,5,0,57.3,10.7,1,
2016,San Francisco 49ers,Home,New Orleans Saints,23,41,486,393,93,571,323,248,70,60,0,0,57.3,12.7,1,
2016,San Francisco 49ers,Home,New England Patriots,17,30,299,177,122,444,273,171,64,64,6,1,57.3,6.7,1,
2016,San Francisco 49ers,Away,Miami Dolphins,24,31,475,282,193,358,263,95,79,49,13,0,57.3,21.7,1,
2016,San Francisco 49ers,Away,Chicago Bears,6,26,147,6,141,326,184,142,33,91,5,1,57.3,24.3,1,
2016,San Francisco 49ers,Home,New York Jets,17,23,364,116,248,404,216,188,54,62,8,0,57.3,3.3,1,
2016,San Francisco 49ers,Away,Los Angeles Rams,22,21,323,253,70,177,78,99,59,44,6,0,57.3,1.7,1,
2015,San Francisco 49ers,Home,St. Louis Rams,19,16,458,350,108,364,231,133,53,59,6,0,57.3,4.3,1,
2015,San Francisco 49ers,Home,Minnesota Vikings,20,3,395,165,230,248,177,71,70,63,5,0,57.3,12.7,1,
2015,San Francisco 49ers,Away,Pittsburgh Steelers,18,43,409,298,111,453,369,84,66,60,10,0,57.3,8.7,1,
2015,San Francisco 49ers,Home,Green Bay Packers,3,17,196,119,77,362,200,162,74,36,5,0,57.3,16.7,1,
2015,San Francisco 49ers,Away,New York Giants,27,30,380,256,124,525,441,84,61,59,4,0,57.3,3.7,1,
2015,San Francisco 49ers,Home,Baltimore Ravens,25,20,391,326,65,420,343,77,69,60,7,0,57.3,11.7,1,
2015,San Francisco 49ers,Home,Seattle Seahawks,3,20,142,81,61,388,212,176,75,40,8,0,57.3,17.7,1,
2015,San Francisco 49ers,Home,Atlanta Falcons,17,16,318,185,133,302,285,17,58,84,0,0,57.3,0.7,1,
2015,San Francisco 49ers,Away,Seattle Seahawks,13,29,306,247,59,508,253,255,46,60,6,0,57.3,11.3,1,
2015,San Francisco 49ers,Home,Arizona Cardinals,13,19,368,301,67,337,267,70,54,40,4,0,57.3,3.3,1,
2015,San Francisco 49ers,Away,Chicago Bears,26,20,291,170,121,364,194,170,50,55,5,0,57.3,7.3,1,
2015,San Francisco 49ers,Away,Cleveland Browns,10,24,221,150,71,481,251,230,63,79,11,0,57.3,5.7,1,
2015,San Francisco 49ers,Home,Cincinnati Bengals,14,24,318,263,55,242,174,68,52,63,14,0,57.3,5.3,1,
2015,San Francisco 49ers,Away,Detroit Lions,17,32,322,201,121,371,284,87,68,70,0,0,57.3,10.7,1,
2018,Seattle Seahawks,Away,Denver Broncos,24,27,306,242,64,470,324,146,84,17,5,0,52.65,31.35,1,
2018,Seattle Seahawks,Away,Chicago Bears,17,24,276,202,74,271,185,86,79,62,2,0,52.65,26.35,1,
2018,Seattle Seahawks,Home,Dallas Cowboys,24,13,295,182,113,303,137,166,61,59,4,0,52.65,8.35,1,
2018,Seattle Seahawks,Away,Arizona Cardinals,20,17,331,160,171,263,171,92,68,70,0,0,52.65,15.35,0,
2018,Seattle Seahawks,Home,Los Angeles Rams,31,33,373,183,190,468,313,155,53,79,5,1,52.65,0.35,1,
2018,Seattle Seahawks,Away,Oakland Raiders,27,3,369,214,155,185,106,79,52,93,10,0,52.65,0.65,1,
2018,Seattle Seahawks,Away,Detroit Lions,28,14,413,237,176,331,297,34,68,70,0,0,52.65,15.35,1,
2018,Seattle Seahawks,Home,Los Angeles Chargers,17,25,356,202,154,375,215,160,56,78,4,0,52.65,3.35,1,
2018,Seattle Seahawks,Away,Los Angeles Rams,31,36,414,141,273,456,307,149,75,20,1,0,52.65,22.35,1,
2018,Seattle Seahawks,Home,Green Bay Packers,27,24,378,205,173,359,311,48,54,69,6,0,52.65,1.35,1,
2018,Seattle Seahawks,Away,Carolina Panthers,30,27,397,322,75,476,256,220,57,63,1,0,52.65,4.35,1,
2018,Seattle Seahawks,Home,San Francisco 49ers,43,16,331,163,168,452,386,66,45,81,2,0,52.65,7.65,1,
2018,Seattle Seahawks,Home,Minnesota Vikings,21,7,274,60,214,276,199,77,48,76,9,0,52.65,4.65,1,
2018,Seattle Seahawks,Away,San Francisco 49ers,23,26,385,217,168,351,257,94,61,68,11,0,52.65,8.35,1,
2018,Seattle Seahawks,Home,Kansas City Chiefs,38,31,464,254,210,419,265,154,43,82,8,0,52.65,9.65,1,
2018,Seattle Seahawks,Home,Arizona Cardinals,27,24,291,109,182,198,113,85,45,76,5,0,52.65,7.65,1,
2017,Seattle Seahawks,Away,Green Bay Packers,9,17,225,135,90,370,286,84,71,49,11,0,52.65,18.35,1,
2017,Seattle Seahawks,Home,San Francisco 49ers,12,9,312,181,131,248,89,159,65,60,12,0,52.65,12.35,1,
2017,Seattle Seahawks,Away,Tennessee Titans,27,33,433,364,69,420,225,195,88,97,4,0,52.65,35.35,1,
2017,Seattle Seahawks,Home,Indianapolis Colts,46,18,477,283,194,237,139,98,61,54,8,0,52.65,8.35,1,
2017,Seattle Seahawks,Away,Los Angeles Rams,16,10,241,179,62,375,275,100,78,50,0,0,52.65,25.35,1,
2017,Seattle Seahawks,Away,New York Giants,24,7,425,321,104,177,131,46,75,29,7,0,52.65,22.35,1,
2017,Seattle Seahawks,Home,Houston Texans,41,38,479,446,33,509,367,142,50,90,2,0,52.65,2.65,1,
2017,Seattle Seahawks,Home,Washington Redskins,14,17,437,289,148,244,193,51,36,86,11,1,52.65,16.65,1,
2017,Seattle Seahawks,Away,Arizona Cardinals,22,16,287,212,75,290,256,34,79,32,0,0,52.65,26.35,1,
2017,Seattle Seahawks,Home,Atlanta Falcons,31,34,360,224,136,279,190,89,45,85,6,0,52.65,7.65,1,
2017,Seattle Seahawks,Away,San Francisco 49ers,24,13,318,228,90,280,196,84,66,68,12,0,52.65,13.35,1,
2017,Seattle Seahawks,Home,Philadelphia Eagles,24,10,310,209,101,425,327,98,44,78,3,0,52.65,8.65,1,
2017,Seattle Seahawks,Away,Jacksonville Jaguars,24,30,401,260,141,424,268,156,54,50,5,0,52.65,1.35,1,
2017,Seattle Seahawks,Home,Los Angeles Rams,7,42,149,71,78,352,108,244,47,88,15,0,52.65,5.65,1,
2017,Seattle Seahawks,Home,Arizona Cardinals,24,26,296,195,101,259,143,116,40,78,7,0,52.65,12.65,1,
2016,Seattle Seahawks,Away,San Francisco 49ers,25,23,376,289,87,253,191,62,54,60,5,0,52.65,1.35,1,
2016,Seattle Seahawks,Home,Miami Dolphins,12,10,352,240,112,214,150,64,61,68,2,0,52.65,8.35,1,
2016,Seattle Seahawks,Away,Los Angeles Rams,3,9,306,239,67,283,219,64,88,39,3,0,52.65,35.35,1,
2016,Seattle Seahawks,Home,San Francisco 49ers,37,18,418,291,127,254,119,135,66,63,6,0,52.65,13.35,1,
2016,Seattle Seahawks,Away,New York Jets,27,17,354,288,66,305,247,58,61,77,0,0,52.65,8.35,1,
2016,Seattle Seahawks,Home,Atlanta Falcons,26,24,333,261,72,362,310,52,54,83,10,1,52.65,1.35,1,
2016,Seattle Seahawks,Away,New Orleans Saints,20,25,359,285,74,375,252,123,80,60,5,0,52.65,27.35,1,
2016,Seattle Seahawks,Home,Buffalo Bills,31,25,278,245,33,425,263,162,61,40,4,0,52.65,8.35,1,
2016,Seattle Seahawks,Away,New England Patriots,31,24,420,324,96,385,304,81,43,55,3,0,52.65,9.65,1,
2016,Seattle Seahawks,Home,Philadelphia Eagles,26,15,439,287,152,308,195,113,54,80,5,1,52.65,1.35,1,
2016,Seattle Seahawks,Away,Tampa Bay Buccaneers,5,14,245,118,127,338,220,118,81,47,6,0,52.65,28.35,1,
2016,Seattle Seahawks,Home,Carolina Panthers,40,7,534,294,240,271,182,89,37,71,4,0,52.65,15.65,1,
2016,Seattle Seahawks,Away,Green Bay Packers,10,38,354,218,136,330,237,93,26,85,5,0,52.65,26.65,1,
2016,Seattle Seahawks,Home,Los Angeles Rams,24,3,299,227,72,183,136,47,36,67,5,0,52.65,16.65,1,
2016,Seattle Seahawks,Home,Arizona Cardinals,31,34,391,313,78,370,276,94,39,87,2,0,52.65,13.65,1,
2015,Seattle Seahawks,Away,Green Bay Packers,17,27,324,205,119,361,234,127,62,52,9,0,52.65,9.35,1,
2015,Seattle Seahawks,Home,Chicago Bears,26,0,371,212,159,146,48,98,60,53,5,0,52.65,7.35,1,
2015,Seattle Seahawks,Home,Detroit Lions,13,10,345,235,110,256,203,53,74,41,8,0,52.65,21.35,1,
2015,Seattle Seahawks,Away,Cincinnati Bengals,24,27,397,197,200,419,310,109,66,59,3,0,52.65,13.35,1,
2015,Seattle Seahawks,Home,Carolina Panthers,23,27,334,219,115,383,248,135,61,85,5,0,52.65,8.35,1,
2015,Seattle Seahawks,Away,San Francisco 49ers,20,3,388,212,176,142,81,61,75,40,8,0,52.65,22.35,1,
2015,Seattle Seahawks,Home,Arizona Cardinals,32,39,343,228,115,451,334,117,49,63,0,0,52.65,3.65,1,
2015,Seattle Seahawks,Home,San Francisco 49ers,29,13,508,253,255,306,247,59,46,60,6,0,52.65,6.65,1,
2015,Seattle Seahawks,Home,Pittsburgh Steelers,39,30,436,336,100,538,480,58,38,80,2,0,52.65,14.65,1,
2015,Seattle Seahawks,Away,Minnesota Vikings,38,7,433,260,173,125,94,31,37,86,3,0,52.65,15.65,1,
2015,Seattle Seahawks,Away,Baltimore Ravens,35,6,424,301,123,302,274,28,65,70,2,0,52.65,12.35,1,
2015,Seattle Seahawks,Home,Cleveland Browns,30,13,423,241,182,230,136,94,47,56,10,0,52.65,5.65,1,
2015,Seattle Seahawks,Home,St. Louis Rams,17,23,312,253,59,205,103,102,37,86,0,0,52.65,15.65,1,
2018,Tampa Bay Buccaneers,Away,New Orleans Saints,48,40,529,417,112,475,432,43,86,67,5,0,73.35,12.65,1,
2018,Tampa Bay Buccaneers,Home,Philadelphia Eagles,27,21,436,393,43,412,321,91,91,65,9,0,73.35,17.65,1,
2018,Tampa Bay Buccaneers,Home,Pittsburgh Steelers,27,30,455,392,63,413,335,78,77,89,5,0,73.35,3.65,1,
2018,Tampa Bay Buccaneers,Away,Chicago Bears,10,48,311,251,60,483,344,139,66,62,5,0,73.35,7.35,1,
2018,Tampa Bay Buccaneers,Home,Cleveland Browns,26,23,456,342,114,305,186,119,79,64,7,0,73.35,5.65,1,
2018,Tampa Bay Buccaneers,Away,Cincinnati Bengals,34,37,576,450,126,402,264,138,50,55,77,0,73.35,23.35,1,
2018,Tampa Bay Buccaneers,Away,Carolina Panthers,28,42,301,219,82,407,228,179,62,47,8,0,73.35,11.35,1,
2018,Tampa Bay Buccaneers,Home,Washington Redskins,3,16,501,398,103,286,170,116,82,59,3,0,73.35,8.65,1,
2018,Tampa Bay Buccaneers,Away,New York Giants,35,38,510,359,151,359,196,163,42,54,1,0,73.35,31.35,1,
2018,Tampa Bay Buccaneers,Home,San Francisco 49ers,27,9,412,304,108,342,194,148,77,62,7,0,73.35,3.65,1,
2018,Tampa Bay Buccaneers,Home,Carolina Panthers,24,17,315,220,95,444,276,168,81,75,15,0,73.35,7.65,1,
2018,Tampa Bay Buccaneers,Home,New Orleans Saints,14,28,279,174,105,298,198,100,71,91,7,0,73.35,2.35,1,
2018,Tampa Bay Buccaneers,Away,Baltimore Ravens,12,20,241,156,85,370,128,242,43,97,15,0,73.35,30.35,1,
2018,Tampa Bay Buccaneers,Home,Atlanta Falcons,32,34,433,341,92,489,380,109,80,73,5,0,73.35,6.65,1,
2017,Tampa Bay Buccaneers,Home,Chicago Bears,29,7,311,194,117,310,290,20,88,62,7,0,73.35,14.65,1,
2017,Tampa Bay Buccaneers,Away,Minnesota Vikings,17,34,342,316,26,494,369,125,68,70,0,0,73.35,5.35,0,
2017,Tampa Bay Buccaneers,Home,New York Giants,25,23,434,323,111,379,288,91,91,51,8,0,73.35,17.65,1,
2017,Tampa Bay Buccaneers,Home,New England Patriots,14,19,409,319,90,402,289,113,76,94,9,0,73.35,2.65,1,
2017,Tampa Bay Buccaneers,Away,Buffalo Bills,27,30,447,378,69,434,261,173,74,45,9,0,73.35,0.65,1,
2017,Tampa Bay Buccaneers,Home,Carolina Panthers,3,17,279,194,85,254,154,100,63,63,13,0,73.35,10.35,1,
2017,Tampa Bay Buccaneers,Away,New Orleans Saints,10,30,200,113,87,407,256,151,79,67,1,0,73.35,5.65,1,
2017,Tampa Bay Buccaneers,Home,New York Jets,15,10,271,181,90,275,219,56,79,69,16,0,73.35,5.65,1,
2017,Tampa Bay Buccaneers,Away,Miami Dolphins,30,20,321,268,53,448,365,83,81,51,9,0,73.35,7.65,1,
2017,Tampa Bay Buccaneers,Away,Green Bay Packers,20,26,395,230,165,276,77,199,42,67,8,0,73.35,31.35,1,
2017,Tampa Bay Buccaneers,Home,Detroit Lions,21,24,400,267,133,434,381,53,55,44,9,0,73.35,18.35,1,
2017,Tampa Bay Buccaneers,Home,Atlanta Falcons,21,24,373,289,84,410,209,201,71,85,2,0,73.35,2.35,1,
2017,Tampa Bay Buccaneers,Away,Carolina Panthers,19,22,392,326,66,255,140,115,55,63,6,0,73.35,18.35,1,
2017,Tampa Bay Buccaneers,Home,New Orleans Saints,31,24,455,345,110,323,231,92,71,49,3,0,73.35,2.35,1,
2016,Tampa Bay Buccaneers,Home,Carolina Panthers,17,16,300,188,112,335,207,128,81,65,6,0,73.35,7.65,1,
2016,Tampa Bay Buccaneers,Home,Los Angeles Rams,32,37,472,389,83,320,183,137,91,58,4,0,73.35,17.65,1,
2016,Tampa Bay Buccaneers,Home,Denver Broncos,7,27,215,143,72,307,218,89,88,63,7,0,73.35,14.65,1,
2016,Tampa Bay Buccaneers,Away,Carolina Panthers,17,14,315,202,113,414,278,136,66,35,7,0,73.35,7.35,1,
2016,Tampa Bay Buccaneers,Away,San Francisco 49ers,34,17,513,264,249,273,113,160,68,49,5,0,73.35,5.35,1,
2016,Tampa Bay Buccaneers,Home,Oakland Raiders,24,30,270,168,102,626,498,128,86,54,18,0,73.35,12.65,1,
2016,Tampa Bay Buccaneers,Home,Atlanta Falcons,28,43,396,326,70,461,325,136,76,70,2,0,73.35,2.65,1,
2016,Tampa Bay Buccaneers,Home,Chicago Bears,36,10,360,280,80,283,161,122,81,61,4,0,73.35,7.65,1,
2016,Tampa Bay Buccaneers,Away,Kansas City Chiefs,19,17,442,326,116,343,261,82,46,42,9,0,73.35,27.35,1,
2016,Tampa Bay Buccaneers,Home,Seattle Seahawks,14,5,338,220,118,245,118,127,81,47,6,0,73.35,7.65,1,
2016,Tampa Bay Buccaneers,Away,San Diego Chargers,28,21,349,268,81,330,211,119,72,19,7,0,73.35,1.35,1,
2016,Tampa Bay Buccaneers,Home,New Orleans Saints,16,11,270,166,104,294,248,46,79,69,9,0,73.35,5.65,1,
2016,Tampa Bay Buccaneers,Away,New Orleans Saints,24,31,349,260,89,417,294,123,76,74,7,0,73.35,2.65,1,
2015,Tampa Bay Buccaneers,Away,Carolina Panthers,10,38,386,309,77,366,255,111,54,31,4,0,73.35,19.35,1,
2015,Tampa Bay Buccaneers,Home,Tennessee Titans,14,42,273,181,92,309,185,124,84,66,8,0,73.35,10.65,1,
2015,Tampa Bay Buccaneers,Away,New Orleans Saints,26,19,333,194,139,323,219,104,86,62,4,0,73.35,12.65,1,
2015,Tampa Bay Buccaneers,Away,Houston Texans,9,19,318,261,57,413,227,186,78,74,4,1,73.35,4.65,1,
2015,Tampa Bay Buccaneers,Home,Carolina Panthers,23,37,411,270,141,244,111,133,74,92,5,0,73.35,0.65,1,
2015,Tampa Bay Buccaneers,Home,Jacksonville Jaguars,38,31,369,186,183,325,270,55,84,55,9,0,73.35,10.65,1,
2015,Tampa Bay Buccaneers,Away,Washington Redskins,30,31,479,289,190,355,305,50,64,87,5,0,73.35,9.35,1,
2015,Tampa Bay Buccaneers,Home,New York Giants,18,32,383,247,136,327,213,114,80,90,3,0,73.35,6.65,1,
2015,Tampa Bay Buccaneers,Home,Dallas Cowboys,10,6,330,246,84,228,186,42,79,56,13,0,73.35,5.65,1,
2015,Tampa Bay Buccaneers,Away,Philadelphia Eagles,45,17,521,238,283,383,247,136,48,41,15,0,73.35,25.35,1,
2015,Tampa Bay Buccaneers,Away,Indianapolis Colts,12,25,344,212,132,336,309,27,37,69,10,0,73.35,36.35,1,
2015,Tampa Bay Buccaneers,Home,Atlanta Falcons,23,19,388,222,166,319,255,64,79,63,18,0,73.35,5.65,1,
2015,Tampa Bay Buccaneers,Home,New Orleans Saints,17,24,291,176,115,388,301,87,81,63,15,0,73.35,7.65,1,
2015,Tampa Bay Buccaneers,Home,Chicago Bears,21,26,389,285,104,327,153,174,83,59,13,0,73.35,9.65,1,
2018,Tennessee Titans,Away,Miami Dolphins,20,27,336,220,116,342,222,120,89,63,7,1,59.25,29.75,1,
2018,Tennessee Titans,Home,Houston Texans,20,17,283,183,100,437,289,148,81,63,12,0,59.25,21.75,1,
2018,Tennessee Titans,Away,Jacksonville Jaguars,9,6,233,83,150,232,145,87,89,61,10,0,59.25,29.75,1,
2018,Tennessee Titans,Home,Philadelphia Eagles,26,23,397,327,70,432,315,117,80,56,4,0,59.25,20.75,1,
2018,Tennessee Titans,Away,Buffalo Bills,12,13,221,121,100,223,79,144,62,96,8,0,59.25,2.75,1,
2018,Tennessee Titans,Home,Baltimore Ravens,0,21,106,51,55,361,238,123,66,100,4,1,59.25,6.75,1,
2018,Tennessee Titans,Away,Los Angeles Chargers,19,20,390,226,164,344,297,47,66,75,6,0,59.25,6.75,1,
2018,Tennessee Titans,Away,Dallas Cowboys,28,14,340,215,125,297,225,72,74,58,4,0,59.25,14.75,1,
2018,Tennessee Titans,Home,New England Patriots,34,10,385,235,150,284,244,40,46,42,4,0,59.25,13.25,1,
2018,Tennessee Titans,Away,Indianapolis Colts,10,38,267,176,91,397,295,102,42,81,7,0,59.25,17.25,1,
2018,Tennessee Titans,Away,Houston Texans,17,34,365,260,105,462,181,281,51,35,7,0,59.25,8.25,1,
2018,Tennessee Titans,Home,New York Jets,26,22,403,273,130,280,124,156,70,26,13,0,59.25,10.75,1,
2018,Tennessee Titans,Home,Jacksonville Jaguars,30,9,426,162,264,255,195,60,44,43,5,0,59.25,15.25,1,
2018,Tennessee Titans,Away,New York Giants,17,0,301,86,215,260,213,47,40,95,6,1,59.25,19.25,1,
2018,Tennessee Titans,Home,Washington Redskins,25,16,291,192,99,292,131,161,51,48,9,0,59.25,8.25,1,
2018,Tennessee Titans,Home,Indianapolis Colts,17,33,258,165,93,436,278,158,53,67,4,0,59.25,6.25,1,
2017,Tennessee Titans,Home,Oakland Raiders,16,26,350,255,95,359,250,109,72,50,7,0,59.25,12.75,1,
2017,Tennessee Titans,Away,Jacksonville Jaguars,37,16,390,211,179,310,211,99,84,59,10,0,59.25,24.75,1,
2017,Tennessee Titans,Home,Seattle Seahawks,33,27,420,225,195,433,364,69,88,97,4,0,59.25,28.75,1,
2017,Tennessee Titans,Away,Houston Texans,14,57,195,109,86,445,272,173,87,57,3,0,59.25,27.75,1,
2017,Tennessee Titans,Away,Miami Dolphins,10,16,188,119,69,178,78,100,89,67,9,0,59.25,29.75,1,
2017,Tennessee Titans,Home,Indianapolis Colts,36,22,473,305,168,297,212,85,57,55,7,0,59.25,2.25,1,
2017,Tennessee Titans,Away,Cleveland Browns,12,9,269,189,80,284,218,66,74,56,12,0,59.25,14.75,1,
2017,Tennessee Titans,Home,Baltimore Ravens,23,20,257,186,71,341,268,73,75,66,10,0,59.25,15.75,1,
2017,Tennessee Titans,Home,Cincinnati Bengals,24,20,416,236,180,308,255,53,53,88,4,0,59.25,6.25,1,
2017,Tennessee Titans,Away,Pittsburgh Steelers,17,40,316,264,52,349,284,65,40,67,14,0,59.25,19.25,1,
2017,Tennessee Titans,Away,Indianapolis Colts,20,16,276,184,92,254,165,89,47,51,10,0,59.25,12.25,1,
2017,Tennessee Titans,Home,Houston Texans,24,13,344,146,198,384,331,53,60,39,4,0,59.25,0.75,1,
2017,Tennessee Titans,Away,Arizona Cardinals,7,12,204,139,65,261,125,136,79,7,10,0,59.25,19.75,1,
2017,Tennessee Titans,Away,San Francisco 49ers,23,25,328,238,90,414,363,51,65,17,17,0,59.25,5.75,1,
2017,Tennessee Titans,Home,Los Angeles Rams,23,27,366,269,97,402,286,116,39,90,11,0,59.25,20.25,1,
2017,Tennessee Titans,Home,Jacksonville Jaguars,15,10,232,116,116,229,146,83,23,45,5,0,59.25,36.25,1,
2016,Tennessee Titans,Home,Houston Texans,24,17,236,133,103,289,243,46,52,97,7,0,59.25,7.25,1,
2016,Tennessee Titans,Home,Minnesota Vikings,16,25,316,252,64,301,236,65,76,47,5,0,59.25,16.75,1,
2016,Tennessee Titans,Away,Detroit Lions,16,15,363,224,139,375,238,137,68,70,0,0,59.25,8.75,1,
2016,Tennessee Titans,Home,Oakland Raiders,10,17,393,212,181,368,245,123,89,49,2,0,59.25,29.75,1,
2016,Tennessee Titans,Away,Houston Texans,20,27,320,196,124,359,244,115,82,48,9,0,59.25,22.75,1,
2016,Tennessee Titans,Away,Miami Dolphins,30,17,398,163,235,200,149,51,88,53,13,0,59.25,28.75,1,
2016,Tennessee Titans,Home,Cleveland Browns,28,26,407,270,137,341,301,40,75,70,10,0,59.25,15.75,1,
2016,Tennessee Titans,Home,Indianapolis Colts,26,34,331,207,124,422,341,81,68,50,5,0,59.25,8.75,1,
2016,Tennessee Titans,Home,Jacksonville Jaguars,36,22,494,280,214,370,322,48,71,78,3,0,59.25,11.75,1,
2016,Tennessee Titans,Away,San Diego Chargers,35,43,393,313,80,476,268,208,76,48,6,0,59.25,16.75,1,
2016,Tennessee Titans,Home,Green Bay Packers,47,25,446,292,154,402,333,69,56,49,3,0,59.25,3.25,1,
2016,Tennessee Titans,Away,Indianapolis Colts,17,24,351,254,97,327,251,76,34,61,10,0,59.25,25.25,1,
2016,Tennessee Titans,Away,Chicago Bears,27,21,375,226,149,411,316,95,40,88,11,0,59.25,19.25,1,
2016,Tennessee Titans,Home,Denver Broncos,13,10,253,73,180,348,330,18,50,37,5,0,59.25,9.25,1,
2016,Tennessee Titans,Away,Kansas City Chiefs,19,17,389,241,148,316,159,157,1,65,5,0,59.25,58.25,1,
2016,Tennessee Titans,Away,Jacksonville Jaguars,17,38,263,205,58,415,331,84,67,84,5,0,59.25,7.75,1,
2015,Tennessee Titans,Away,Indianapolis Colts,24,30,231,94,137,327,200,127,30,79,9,0,59.25,29.25,1,
2015,Tennessee Titans,Away,Tampa Bay Buccaneers,42,14,309,185,124,273,181,92,84,66,8,0,59.25,24.75,1,
2015,Tennessee Titans,Away,Cleveland Browns,14,28,385,219,166,274,158,116,64,59,12,0,59.25,4.75,1,
2015,Tennessee Titans,Home,Indianapolis Colts,33,35,433,345,88,378,245,133,74,77,3,0,59.25,14.75,1,
2015,Tennessee Titans,Home,Buffalo Bills,13,14,276,179,97,209,82,127,67,58,5,0,59.25,7.75,1,
2015,Tennessee Titans,Home,Miami Dolphins,10,38,299,236,63,434,254,180,56,39,8,0,59.25,3.25,1,
2015,Tennessee Titans,Home,Atlanta Falcons,7,10,256,179,77,378,251,127,59,95,8,0,59.25,0.25,1,
2015,Tennessee Titans,Away,Houston Texans,6,20,211,125,86,270,214,56,70,86,0,1,59.25,10.75,1,
2015,Tennessee Titans,Away,New Orleans Saints,34,28,483,371,112,416,355,61,60,90,17,0,59.25,0.75,1,
2015,Tennessee Titans,Home,Carolina Panthers,10,27,242,178,64,336,217,119,57,24,2,0,59.25,2.25,1,
2015,Tennessee Titans,Away,Jacksonville Jaguars,13,19,316,212,104,308,218,90,75,90,5,0,59.25,15.75,1,
2015,Tennessee Titans,Home,Oakland Raiders,21,24,249,205,44,407,323,84,56,100,4,1,59.25,3.25,1,
2015,Tennessee Titans,Home,Jacksonville Jaguars,42,39,467,257,210,383,302,81,56,60,1,0,59.25,3.25,1,
2015,Tennessee Titans,Away,New York Jets,8,30,292,268,24,439,256,183,67,56,5,0,59.25,7.75,1,
2015,Tennessee Titans,Away,New England Patriots,16,33,282,223,59,346,253,93,40,41,12,0,59.25,19.25,1,
2015,Tennessee Titans,Home,Houston Texans,6,34,257,227,30,330,202,128,73,75,16,0,59.25,13.75,1,
2018,Washington Redskins,Away,Arizona Cardinals,24,6,429,247,182,213,145,68,68,70,0,0,55.7,12.3,0,
2018,Washington Redskins,Home,Indianapolis Colts,9,21,334,269,65,281,177,104,71,88,5,0,55.7,15.3,1,
2018,Washington Redskins,Home,Green Bay Packers,31,17,386,220,166,340,240,100,62,96,6,1,55.7,6.3,1,
2018,Washington Redskins,Away,New Orleans Saints,19,43,283,244,39,447,349,98,84,70,22,0,55.7,28.3,1,
2018,Washington Redskins,Home,Carolina Panthers,23,17,288,156,132,350,269,81,52,74,0,0,55.7,3.7,1,
2018,Washington Redskins,Home,Dallas Cowboys,20,17,305,175,130,323,250,73,52,43,12,0,55.7,3.7,1,
2018,Washington Redskins,Away,New York Giants,20,13,360,178,182,303,266,37,51,73,11,0,55.7,4.7,1,
2018,Washington Redskins,Home,Atlanta Falcons,14,38,366,287,79,491,337,154,55,46,5,0,55.7,0.7,1,
2018,Washington Redskins,Away,Tampa Bay Buccaneers,16,3,286,170,116,501,398,103,82,59,3,0,55.7,26.3,1,
2018,Washington Redskins,Home,Houston Texans,21,23,278,154,124,320,181,139,48,56,6,0,55.7,7.7,1,
2018,Washington Redskins,Away,Philadelphia Eagles,13,28,235,131,104,436,306,130,36,58,15,0,55.7,19.7,1,
2018,Washington Redskins,Home,New York Giants,16,40,288,204,84,402,175,227,33,57,6,0,55.7,22.7,1,
2018,Washington Redskins,Away,Jacksonville Jaguars,16,13,245,136,109,192,20,172,64,58,12,0,55.7,8.3,1,
2018,Washington Redskins,Away,Tennessee Titans,16,25,292,131,161,291,192,99,51,48,9,0,55.7,4.7,1,
2018,Washington Redskins,Home,Philadelphia Eagles,0,24,89,68,21,360,231,129,46,62,3,0,55.7,9.7,1,
2017,Washington Redskins,Home,Philadelphia Eagles,17,30,264,200,64,356,298,58,67,54,5,0,55.7,11.3,1,
2017,Washington Redskins,Away,Los Angeles Rams,27,20,385,156,229,332,235,97,76,59,3,0,55.7,20.3,1,
2017,Washington Redskins,Home,Oakland Raiders,27,10,472,356,116,128,96,32,76,75,0,0,55.7,20.3,1,
2017,Washington Redskins,Away,Kansas City Chiefs,20,29,331,220,111,429,261,168,82,55,14,0,55.7,26.3,1,
2017,Washington Redskins,Home,San Francisco 49ers,26,24,419,325,94,335,250,85,68,85,4,0,55.7,12.3,1,
2017,Washington Redskins,Away,Philadelphia Eagles,24,34,344,269,75,371,244,127,70,78,9,0,55.7,14.3,1,
2017,Washington Redskins,Home,Dallas Cowboys,19,33,285,236,49,307,138,169,60,93,4,1,55.7,4.3,1,
2017,Washington Redskins,Away,Seattle Seahawks,17,14,244,193,51,437,289,148,36,86,11,1,55.7,19.7,1,
2017,Washington Redskins,Home,Minnesota Vikings,30,38,394,313,81,406,304,102,44,44,4,0,55.7,11.7,1,
2017,Washington Redskins,Away,New Orleans Saints,31,34,456,300,156,535,375,160,57,44,12,0,55.7,1.3,1,
2017,Washington Redskins,Home,New York Giants,20,10,323,201,122,170,86,84,33,67,0,0,55.7,22.7,1,
2017,Washington Redskins,Away,Dallas Cowboys,14,38,280,224,56,275,93,182,58,56,3,0,55.7,2.3,1,
2017,Washington Redskins,Away,Los Angeles Chargers,13,30,201,136,65,488,314,174,81,10,4,0,55.7,25.3,1,
2017,Washington Redskins,Home,Arizona Cardinals,20,15,218,187,31,286,145,141,50,47,1,0,55.7,5.7,1,
2017,Washington Redskins,Home,Denver Broncos,27,11,386,299,87,330,171,159,43,59,7,0,55.7,12.7,1,
2017,Washington Redskins,Away,New York Giants,10,18,197,136,61,381,121,260,16,42,16,0,55.7,39.7,1,
2016,Washington Redskins,Home,New York Giants,10,19,284,246,38,332,171,161,53,51,1,0,55.7,2.7,1,
2016,Washington Redskins,Home,Pittsburgh Steelers,16,38,384,329,55,437,290,147,79,41,4,0,55.7,23.3,1,
2016,Washington Redskins,Home,Dallas Cowboys,23,27,432,350,82,380,278,102,81,65,6,0,55.7,25.3,1,
2016,Washington Redskins,Away,New York Giants,29,27,403,313,90,457,337,120,67,37,2,0,55.7,11.3,1,
2016,Washington Redskins,Home,Cleveland Browns,31,20,301,156,145,380,217,163,67,89,1,0,55.7,11.3,1,
2016,Washington Redskins,Away,Baltimore Ravens,16,10,310,250,60,306,188,118,62,53,16,0,55.7,6.3,1,
2016,Washington Redskins,Home,Philadelphia Eagles,27,20,493,263,230,239,145,94,69,62,13,0,55.7,13.3,1,
2016,Washington Redskins,Away,Detroit Lions,17,20,413,283,130,344,250,94,68,70,0,0,55.7,12.3,1,
2016,Washington Redskins,Away,Cincinnati Bengals,27,27,546,446,100,415,263,152,54,90,2,0,55.7,1.7,1,
2016,Washington Redskins,Home,Minnesota Vikings,26,20,388,260,128,331,284,47,58,24,7,0,55.7,2.3,1,
2016,Washington Redskins,Home,Green Bay Packers,42,24,515,364,151,424,340,84,38,44,23,0,55.7,17.7,1,
2016,Washington Redskins,Away,Arizona Cardinals,23,31,333,246,87,369,281,88,68,13,0,0,55.7,12.3,1,
2016,Washington Redskins,Away,Philadelphia Eagles,27,22,334,227,107,383,288,95,35,50,3,0,55.7,20.7,1,
2016,Washington Redskins,Home,Carolina Panthers,15,26,335,306,29,438,290,148,32,56,8,0,55.7,23.7,1,
2016,Washington Redskins,Away,Chicago Bears,41,21,478,270,208,458,318,140,37,79,1,0,55.7,18.7,1,
2015,Washington Redskins,Home,Miami Dolphins,10,17,349,188,161,256,182,74,69,58,10,0,55.7,13.3,1,
2015,Washington Redskins,Home,St. Louis Rams,24,10,373,191,182,213,146,67,72,56,9,0,55.7,16.3,1,
2015,Washington Redskins,Away,New York Giants,21,32,393,305,88,363,279,84,71,60,4,0,55.7,15.3,1,
2015,Washington Redskins,Home,Philadelphia Eagles,23,20,417,290,127,320,233,87,58,82,13,0,55.7,2.3,1,
2015,Washington Redskins,Away,New York Jets,20,34,225,191,34,474,253,221,49,30,16,0,55.7,6.7,1,
2015,Washington Redskins,Home,Tampa Bay Buccaneers,31,30,355,305,50,479,289,190,64,87,5,0,55.7,8.3,1,
2015,Washington Redskins,Away,New England Patriots,10,27,250,213,37,460,299,161,54,34,12,0,55.7,1.7,1,
2015,Washington Redskins,Home,New Orleans Saints,47,14,510,301,209,350,192,158,61,29,5,0,55.7,5.3,1,
2015,Washington Redskins,Away,Carolina Panthers,16,44,186,172,14,368,226,142,50,63,8,0,55.7,5.7,1,
2015,Washington Redskins,Home,New York Giants,20,14,407,302,105,332,299,33,46,93,5,0,55.7,9.7,1,
2015,Washington Redskins,Home,Dallas Cowboys,16,19,266,193,73,318,221,97,41,75,0,0,55.7,14.7,1,
2015,Washington Redskins,Away,Chicago Bears,24,21,374,275,99,377,290,87,62,80,12,1,55.7,6.3,1,
2015,Washington Redskins,Home,Buffalo Bills,35,25,431,308,123,452,212,240,43,30,3,0,55.7,12.7,1,
2015,Washington Redskins,Away,Philadelphia Eagles,38,24,418,351,67,398,353,45,52,72,6,0,55.7,3.7,1,